CustomerID,Recency,Frequency,Monetary,R_Score,F_Score,M_Score,RFM_Score,Segment
12346,325,2,0.0,1,2,1,4,Returned/Churned
12347,2,7,163.16,4,4,4,12,Champions
12348,75,4,331.36,2,3,4,9,Loyal Customers
12349,18,1,15.0,3,1,1,5,Potential Customers
12350,310,1,25.200000000000003,1,1,2,4,At Risk
12352,36,11,-140.05,3,4,1,8,Returned/Churned
12353,204,1,19.9,1,1,2,4,At Risk
12354,232,1,20.8,1,1,2,4,At Risk
12355,214,1,30.0,1,1,2,4,At Risk
12356,22,3,153.9,3,2,4,9,Loyal Customers
12357,33,1,19.799999999999997,3,1,2,6,Potential Customers
12358,1,2,157.8,4,2,4,10,Champions
12359,7,6,16.9,4,4,2,10,Champions
12360,52,3,46.3,2,2,3,7,Loyal Customers
12361,287,1,23.4,1,1,2,4,At Risk
12362,3,13,191.93,4,4,4,12,Champions
12363,109,2,85.26,2,2,3,7,Loyal Customers
12364,7,4,80.7,4,3,3,10,Champions
12365,291,3,15.0,1,2,1,4,At Risk
12367,4,1,10.2,4,1,1,6,Potential Customers
12370,51,4,321.38,2,3,4,9,Loyal Customers
12371,44,2,365.04,3,2,4,9,Loyal Customers
12372,71,3,90.11999999999999,2,2,3,7,Loyal Customers
12373,311,1,19.5,1,1,2,4,At Risk
12374,25,1,13.049999999999999,3,1,1,5,Potential Customers
12375,2,3,72.72,4,2,3,9,Loyal Customers
12377,315,2,57.0,1,2,3,6,Potential Customers
12378,129,1,12.600000000000001,2,1,1,4,At Risk
12379,81,3,90.74999999999999,2,2,3,7,Loyal Customers
12380,21,5,216.47000000000003,3,3,4,10,Champions
12381,4,6,73.15,4,4,3,11,Champions
12383,184,6,91.15,1,4,3,8,Loyal Customers
12384,28,3,30.05,3,2,2,7,Loyal Customers
12386,337,2,98.0,1,2,3,6,Potential Customers
12388,15,6,140.52,4,4,4,12,Champions
12390,79,1,19.8,2,1,2,5,Potential Customers
12391,21,1,2.95,3,1,1,5,Potential Customers
12393,72,4,67.2,2,3,3,8,Loyal Customers
12394,63,2,156.20000000000002,2,2,4,8,Loyal Customers
12395,15,15,195.08,4,4,4,12,Champions
12397,35,2,31.85,3,2,2,7,Loyal Customers
12398,45,1,15.0,3,1,1,5,Potential Customers
12399,119,4,136.2,2,3,4,9,Loyal Customers
12401,303,1,17.85,1,1,2,4,At Risk
12402,323,1,19.5,1,1,2,4,At Risk
12403,49,2,148.0,3,2,4,9,Loyal Customers
12405,148,1,12.48,1,1,1,3,At Risk
12406,22,3,109.55000000000001,3,2,3,8,Loyal Customers
12407,49,5,248.24,3,3,4,10,Champions
12408,32,9,56.650000000000006,3,4,3,10,Champions
12409,78,7,132.89,2,4,4,10,Champions
12410,301,3,30.25,1,2,2,5,Potential Customers
12412,74,3,44.76,2,2,3,7,Loyal Customers
12413,66,5,-19.849999999999998,2,3,1,6,Returned/Churned
12414,217,3,126.36000000000001,1,2,4,7,Loyal Customers
12415,24,26,5673.55,3,4,4,11,Champions
12417,3,12,101.60000000000001,4,4,3,11,Champions
12418,112,1,10.08,2,1,1,4,At Risk
12420,63,1,18.72,2,1,2,5,Potential Customers
12421,15,5,72.13,4,3,3,10,Champions
12422,95,3,50.7,2,2,3,7,Loyal Customers
12423,0,9,70.53,4,4,3,11,Champions
12424,162,2,229.14000000000001,1,2,4,7,Loyal Customers
12425,78,1,8.5,2,1,1,4,At Risk
12426,194,1,17.700000000000003,1,1,2,4,At Risk
12427,11,5,7.230000000000004,4,3,1,8,Loyal Customers
12428,25,12,720.2800000000001,3,4,4,11,Champions
12429,9,4,161.18,4,3,4,11,Champions
12430,43,1,9.959999999999999,3,1,1,5,Potential Customers
12431,35,18,1066.1200000000001,3,4,4,11,Champions
12432,42,5,885.1,3,3,4,10,Champions
12433,0,7,198.95999999999998,4,4,4,12,Champions
12434,84,4,7.950000000000005,2,3,1,6,Potential Customers
12435,79,2,464.4,2,2,4,8,Loyal Customers
12436,99,1,12.600000000000001,2,1,1,4,At Risk
12437,1,19,630.86,4,4,4,12,Champions
12438,14,2,36.4,4,2,2,8,Loyal Customers
12441,366,1,10.5,1,1,1,3,At Risk
12442,3,1,17.4,4,1,2,7,Loyal Customers
12444,21,5,202.51,3,3,4,10,Champions
12445,22,1,30.0,3,1,2,6,Potential Customers
12446,57,1,6.8,2,1,1,4,At Risk
12447,243,1,19.5,1,1,2,4,At Risk
12448,44,1,19.799999999999997,3,1,2,6,Potential Customers
12449,22,4,121.5,3,3,4,10,Champions
12450,156,2,76.2,1,2,3,6,Potential Customers
12451,10,6,-40.379999999999995,4,4,1,9,Returned/Churned
12452,16,3,97.8,4,2,3,9,Loyal Customers
12453,134,1,19.799999999999997,2,1,2,5,Potential Customers
12454,53,2,0.0,2,2,1,5,Returned/Churned
12455,73,6,109.37,2,4,3,9,Loyal Customers
12456,44,4,48.83,3,3,3,9,Loyal Customers
12457,58,12,368.54999999999995,2,4,4,10,Champions
12458,71,2,45.12,2,2,3,7,Loyal Customers
12461,94,2,213.52,2,2,4,8,Loyal Customers
12462,2,4,14.559999999999999,4,3,1,8,Loyal Customers
12463,46,7,70.01,3,4,3,10,Champions
12464,10,8,259.4,4,4,4,12,Champions
12465,7,3,20.85,4,2,2,8,Loyal Customers
12468,143,3,45.650000000000006,2,2,3,7,Loyal Customers
12471,2,49,1880.7899999999997,4,4,4,12,Champions
12472,30,13,58.66,3,4,3,10,Champions
12473,29,9,-382.84999999999997,3,4,1,8,Returned/Churned
12474,17,30,157.93,3,4,4,11,Champions
12475,53,1,30.24,2,1,2,5,Potential Customers
12476,1,20,456.74,4,4,4,12,Champions
12477,22,9,240.92,3,4,4,11,Champions
12478,3,1,135.0,4,1,4,9,Loyal Customers
12479,3,3,-16.7,4,2,1,7,Returned/Churned
12480,28,4,59.04,3,3,3,9,Loyal Customers
12481,22,11,191.1,3,4,4,11,Champions
12483,17,13,190.55,3,4,4,11,Champions
12484,32,8,417.75,3,4,4,11,Champions
12488,9,3,50.25000000000001,4,2,3,9,Loyal Customers
12489,336,1,36.0,1,1,2,4,At Risk
12490,5,10,361.38,4,4,4,12,Champions
12491,38,1,15.600000000000001,3,1,2,6,Potential Customers
12492,63,2,29.1,2,2,2,6,Potential Customers
12493,165,3,24.51,1,2,2,5,Potential Customers
12494,9,13,23.459999999999997,4,4,2,10,Champions
12497,81,1,177.60000000000002,2,1,4,7,Loyal Customers
12498,21,3,41.050000000000004,3,2,3,8,Loyal Customers
12500,23,13,1188.19,3,4,4,11,Champions
12501,315,2,2.55,1,2,1,4,At Risk
12502,95,5,299.9,2,3,4,9,Loyal Customers
12503,337,1,-1126.0,1,1,1,3,Returned/Churned
12504,18,4,2.799999999999997,3,3,1,7,Loyal Customers
12505,301,1,-4.5,1,1,1,3,Returned/Churned
12506,232,1,7.95,1,1,1,3,At Risk
12507,134,4,55.2,2,3,3,8,Loyal Customers
12508,26,2,10.8,3,2,1,6,Potential Customers
12509,284,1,49.5,1,1,3,5,Potential Customers
12510,142,2,195.72,2,2,4,8,Loyal Customers
12512,66,2,13.9,2,2,1,5,Potential Customers
12513,84,2,-17.0,2,2,1,5,Returned/Churned
12514,267,1,35.7,1,1,2,4,At Risk
12515,353,1,17.0,1,1,2,4,At Risk
12516,77,2,145.28,2,2,4,8,Loyal Customers
12517,28,6,90.45,3,4,3,10,Champions
12518,0,5,117.0,4,3,4,11,Champions
12519,63,1,30.599999999999998,2,1,2,5,Potential Customers
12520,79,6,49.39,2,4,3,9,Loyal Customers
12521,142,1,15.299999999999999,2,1,2,5,Potential Customers
12522,39,2,34.22,3,2,2,7,Loyal Customers
12523,1,13,160.32,4,4,4,12,Champions
12524,9,8,453.23,4,4,4,12,Champions
12526,0,3,56.2,4,2,3,9,Loyal Customers
12527,81,3,102.10000000000001,2,2,3,7,Loyal Customers
12528,9,8,127.60000000000001,4,4,4,12,Champions
12530,59,5,172.70000000000002,2,3,4,9,Loyal Customers
12531,14,1,4.35,4,1,1,6,Potential Customers
12532,30,1,9.36,3,1,1,5,Potential Customers
12534,130,1,16.5,2,1,2,5,Potential Customers
12535,91,2,61.550000000000004,2,2,3,7,Loyal Customers
12536,7,5,-19.40000000000036,4,3,1,8,Returned/Churned
12538,29,1,39.8,3,1,3,7,Loyal Customers
12539,22,5,-1663.02,3,3,1,7,Returned/Churned
12540,19,19,554.53,3,4,4,11,Champions
12541,29,3,75.4,3,2,3,8,Loyal Customers
12544,29,2,8.5,3,2,1,6,Potential Customers
12545,75,2,34.9,2,2,2,6,Potential Customers
12546,46,3,22.6,3,2,2,7,Loyal Customers
12547,197,2,50.4,1,2,3,6,Potential Customers
12548,166,1,17.4,1,1,2,4,At Risk
12550,79,1,20.8,2,1,2,5,Potential Customers
12551,357,1,19.5,1,1,2,4,At Risk
12552,38,2,133.52,3,2,4,9,Loyal Customers
12553,8,14,217.59,4,4,4,12,Champions
12556,50,2,14.19,3,2,1,6,Potential Customers
12557,16,5,1165.24,4,3,4,11,Champions
12558,1,2,-15.760000000000002,4,2,1,7,Returned/Churned
12559,310,3,64.60000000000001,1,2,3,6,Potential Customers
12560,5,4,178.12,4,3,4,11,Champions
12561,302,1,12.600000000000001,1,1,1,3,At Risk
12562,8,7,185.34,4,4,4,12,Champions
12564,261,1,23.4,1,1,2,4,At Risk
12565,281,2,-9.71,1,2,1,4,Returned/Churned
12566,72,2,10.05,2,2,1,5,Potential Customers
12567,22,11,191.94,3,4,4,11,Champions
12569,2,35,626.44,4,4,4,12,Champions
12571,39,2,20.159999999999997,3,2,2,7,Loyal Customers
12572,8,3,61.65,4,2,3,9,Loyal Customers
12573,227,1,8.4,1,1,1,3,At Risk
12574,315,1,15.0,1,1,1,3,At Risk
12576,35,6,68.73,3,4,3,10,Champions
12577,35,4,-49.00000000000001,3,3,1,7,Returned/Churned
12578,21,4,51.85000000000001,3,3,3,9,Loyal Customers
12579,73,3,-13.799999999999999,2,2,1,5,Returned/Churned
12580,246,1,19.799999999999997,1,1,2,4,At Risk
12581,39,1,8.5,3,1,1,5,Potential Customers
12582,238,2,23.799999999999997,1,2,2,5,Potential Customers
12583,2,18,534.81,4,4,4,12,Champions
12584,3,18,-21.199999999999996,4,4,1,9,Returned/Churned
12585,234,4,66.83,1,3,3,7,Loyal Customers
12586,17,2,7.960000000000001,3,2,1,6,Potential Customers
12587,7,1,20.8,4,1,2,7,Loyal Customers
12588,39,1,32.849999999999994,3,1,2,6,Potential Customers
12589,28,2,27.4,3,2,2,7,Loyal Customers
12590,190,3,759.16,1,2,4,7,Loyal Customers
12591,317,1,15.299999999999999,1,1,2,4,At Risk
12592,92,2,42.0,2,2,3,7,Loyal Customers
12593,108,3,52.8,2,2,3,7,Loyal Customers
12594,37,11,350.28000000000003,3,4,4,11,Champions
12596,51,2,76.74,2,2,3,7,Loyal Customers
12597,19,5,113.05,3,3,4,10,Champions
12598,9,9,178.48,4,4,4,12,Champions
12599,29,7,206.08,3,4,4,11,Champions
12600,28,11,271.2,3,4,4,11,Champions
12601,189,6,170.70000000000002,1,4,4,9,Loyal Customers
12602,58,1,23.9,2,1,2,5,Potential Customers
12603,21,1,613.1999999999999,3,1,4,8,Loyal Customers
12604,79,2,45.300000000000004,2,2,3,7,Loyal Customers
12605,365,1,-1.65,1,1,1,3,Returned/Churned
12607,58,2,9.799999999999997,2,2,1,5,Potential Customers
12609,78,3,49.56,2,2,3,7,Loyal Customers
12610,22,7,234.09999999999997,3,4,4,11,Champions
12611,52,1,15.9,2,1,2,5,Potential Customers
12612,57,2,50.75,2,2,3,7,Loyal Customers
12613,31,6,96.63000000000001,3,4,3,10,Champions
12614,277,1,9.95,1,1,1,3,At Risk
12615,2,4,235.04,4,3,4,11,Champions
12616,85,5,-22.85,2,3,1,6,Returned/Churned
12617,29,1,25.0,3,1,2,6,Potential Customers
12618,21,1,15.0,3,1,1,5,Potential Customers
12619,16,13,520.5,4,4,4,12,Champions
12620,14,3,48.3,4,2,3,9,Loyal Customers
12621,1,23,581.98,4,4,4,12,Champions
12622,232,1,20.8,1,1,2,4,At Risk
12623,276,1,15.6,1,1,2,4,At Risk
12624,106,2,25.5,2,2,2,6,Potential Customers
12625,211,3,81.8,1,2,3,6,Potential Customers
12626,23,13,93.26,3,4,3,10,Champions
12627,10,7,201.97,4,4,4,12,Champions
12628,4,4,45.94,4,3,3,10,Champions
12630,9,2,53.10000000000001,4,2,3,9,Loyal Customers
12631,57,1,19.8,2,1,2,5,Potential Customers
12633,58,5,226.88,2,3,4,9,Loyal Customers
12635,89,2,27.36,2,2,2,6,Potential Customers
12637,67,10,155.42,2,4,4,10,Champions
12638,33,1,9.36,3,1,1,5,Potential Customers
12639,238,1,15.0,1,1,1,3,At Risk
12640,23,3,63.18,3,2,3,8,Loyal Customers
12641,115,1,14.850000000000001,2,1,1,4,At Risk
12642,25,3,136.3,3,2,4,9,Loyal Customers
12643,128,6,237.36,2,4,4,10,Champions
12644,129,1,17.4,2,1,2,5,Potential Customers
12645,33,5,146.70000000000002,3,3,4,10,Champions
12646,4,2,66.84,4,2,3,9,Loyal Customers
12647,22,13,407.33,3,4,4,11,Champions
12648,154,1,10.2,1,1,1,3,At Risk
12649,107,4,94.2,2,3,3,8,Loyal Customers
12650,3,1,4.68,4,1,1,6,Potential Customers
12651,334,1,7.800000000000001,1,1,1,3,At Risk
12652,322,2,8.95,1,2,1,4,At Risk
12653,148,2,50.4,1,2,3,6,Potential Customers
12654,10,5,75.1,4,3,3,10,Champions
12656,17,8,121.49,3,4,4,11,Champions
12657,11,5,81.9,4,3,3,10,Champions
12658,18,1,13.200000000000001,3,1,1,5,Potential Customers
12659,29,1,15.0,3,1,1,5,Potential Customers
12660,11,1,19.799999999999997,4,1,2,7,Loyal Customers
12662,0,12,189.8,4,4,4,12,Champions
12664,8,10,1761.6,4,4,4,12,Champions
12665,324,2,28.75,1,2,2,5,Potential Customers
12666,359,1,-91.44,1,1,1,3,Returned/Churned
12667,58,1,14.850000000000001,2,1,1,4,At Risk
12668,7,6,57.71000000000001,4,4,3,11,Champions
12669,150,4,34.0,1,3,2,6,Potential Customers
12670,10,6,278.49,4,4,4,12,Champions
12672,329,1,19.5,1,1,2,4,At Risk
12673,5,2,11.049999999999999,4,2,1,7,Loyal Customers
12674,11,7,199.88,4,4,4,12,Champions
12676,24,6,229.59,3,4,4,11,Champions
12678,42,13,2491.54,3,4,4,11,Champions
12679,52,9,179.42000000000002,2,4,4,10,Champions
12680,0,4,65.16,4,3,3,10,Champions
12681,14,27,653.46,4,4,4,12,Champions
12682,3,31,1258.94,4,4,4,12,Champions
12683,4,20,410.84000000000003,4,4,4,12,Champions
12684,7,7,181.68,4,4,4,12,Champions
12685,28,6,142.82,3,4,4,11,Champions
12686,371,1,17.4,1,1,2,4,At Risk
12688,113,1,75.0,2,1,3,6,Potential Customers
12689,25,2,49.599999999999994,3,2,3,8,Loyal Customers
12690,205,1,24.96,1,1,2,4,At Risk
12691,28,6,383.4,3,4,4,11,Champions
12693,120,6,50.69,2,4,3,9,Loyal Customers
12694,70,2,20.28,2,2,2,6,Potential Customers
12695,7,4,102.65,4,3,3,10,Champions
12697,21,5,156.28,3,3,4,10,Champions
12700,7,6,-6.0,4,4,1,9,Returned/Churned
12701,79,2,32.4,2,2,2,6,Potential Customers
12702,19,1,25.200000000000003,3,1,2,6,Potential Customers
12703,64,2,-2.0500000000000016,2,2,1,5,Returned/Churned
12704,7,10,195.77999999999997,4,4,4,12,Champions
12705,15,14,208.39000000000001,4,4,4,12,Champions
12707,291,1,12.600000000000001,1,1,1,3,At Risk
12708,29,16,147.25,3,4,4,11,Champions
12709,3,26,445.41,4,4,4,12,Champions
12710,96,4,26.58,2,3,2,7,Loyal Customers
12712,22,17,504.25000000000006,3,4,4,11,Champions
12713,0,1,54.0,4,1,3,8,Loyal Customers
12714,9,5,72.08,4,3,3,10,Champions
12715,106,1,12.5,2,1,1,4,At Risk
12716,3,2,28.8,4,2,2,8,Loyal Customers
12717,151,3,-20.0,1,2,1,4,Returned/Churned
12718,71,1,9.36,2,1,1,4,At Risk
12719,5,3,12.499999999999998,4,2,1,7,Loyal Customers
12720,2,29,426.56,4,4,4,12,Champions
12721,31,7,105.15,3,4,3,10,Champions
12722,85,6,27.21,2,4,2,8,Loyal Customers
12723,3,5,70.17,4,3,3,10,Champions
12724,5,4,85.84,4,3,3,10,Champions
12725,371,1,15.0,1,1,1,3,At Risk
12726,28,7,173.1,3,4,4,11,Champions
12727,10,9,145.0,4,4,4,12,Champions
12728,71,4,83.59,2,3,3,8,Loyal Customers
12729,113,1,25.200000000000003,2,1,2,5,Potential Customers
12731,23,14,1321.26,3,4,4,11,Champions
12732,179,1,33.2,1,1,2,4,At Risk
12733,234,1,27.650000000000002,1,1,2,4,At Risk
12734,352,1,8.4,1,1,1,3,At Risk
12735,315,2,62.15,1,2,3,6,Potential Customers
12736,332,1,90.0,1,1,3,5,Potential Customers
12738,372,1,17.4,1,1,2,4,At Risk
12739,78,2,57.3,2,2,3,7,Loyal Customers
12740,63,1,13.200000000000001,2,1,1,4,At Risk
12743,134,2,18.25,2,2,2,6,Potential Customers
12744,51,10,284.46000000000004,2,4,4,10,Champions
12747,2,11,689.49,4,4,4,12,Champions
12748,0,224,627.1600000000001,4,4,4,12,Champions
12749,3,8,62.25,4,4,3,11,Champions
12750,128,1,15.0,2,1,1,4,At Risk
12752,81,1,15.9,2,1,2,5,Potential Customers
12753,3,11,799.3199999999999,4,4,4,12,Champions
12754,235,5,63.83999999999999,1,3,3,7,Loyal Customers
12755,249,4,2191.6,1,3,4,8,Loyal Customers
12756,86,1,61.199999999999996,2,1,3,6,Potential Customers
12757,15,19,230.30000000000004,4,4,4,12,Champions
12758,116,2,90.06,2,2,3,7,Loyal Customers
12759,52,3,54.6,2,2,3,7,Loyal Customers
12762,7,2,35.599999999999994,4,2,2,8,Loyal Customers
12763,138,2,102.3,2,2,3,7,Loyal Customers
12764,316,1,17.4,1,1,2,4,At Risk
12766,3,7,148.56,4,4,4,12,Champions
12769,238,1,175.2,1,1,4,6,Potential Customers
12770,210,1,69.12,1,1,3,5,Potential Customers
12772,59,1,6.8,2,1,1,4,At Risk
12775,17,6,82.6,3,4,3,10,Champions
12778,19,7,89.10000000000001,3,4,3,10,Champions
12779,21,12,253.84,3,4,4,11,Champions
12781,21,5,-5.530000000000001,3,3,1,7,Returned/Churned
12782,4,6,106.08,4,4,3,11,Champions
12783,2,8,32.34000000000002,4,4,2,10,Champions
12784,9,2,76.8,4,2,3,9,Loyal Customers
12785,2,2,10.26,4,2,1,7,Loyal Customers
12787,9,3,124.2,4,2,4,10,Champions
12789,65,1,39.95,2,1,3,6,Potential Customers
12790,192,1,10.08,1,1,1,3,At Risk
12791,373,1,177.60000000000002,1,1,4,6,Potential Customers
12792,256,1,15.0,1,1,1,3,At Risk
12793,334,2,50.7,1,2,3,6,Potential Customers
12794,53,2,20.279999999999998,2,2,2,6,Potential Customers
12795,18,1,15.0,3,1,1,5,Potential Customers
12797,360,3,-14.850000000000001,1,2,1,4,Returned/Churned
12798,10,3,5885.52,4,2,4,10,Champions
12802,183,2,-2.0,1,2,1,4,Returned/Churned
12808,36,3,42.599999999999994,3,2,3,8,Loyal Customers
12809,168,2,12.750000000000004,1,2,1,4,At Risk
12811,260,3,58.5,1,2,3,6,Potential Customers
12812,44,1,10.2,3,1,1,5,Potential Customers
12814,101,1,85.92,2,1,3,6,Potential Customers
12815,147,2,35.25,1,2,2,5,Potential Customers
12816,95,2,35.550000000000004,2,2,2,6,Potential Customers
12817,281,1,39.599999999999994,1,1,3,5,Potential Customers
12818,178,2,299.45000000000005,1,2,4,7,Loyal Customers
12820,3,4,58.2,4,3,3,10,Champions
12821,214,1,19.92,1,1,2,4,At Risk
12822,70,3,0.9000000000000004,2,2,1,5,Potential Customers
12823,74,5,1759.5,2,3,4,9,Loyal Customers
12824,59,1,5.04,2,1,1,4,At Risk
12826,2,8,119.5,4,4,4,12,Champions
12827,5,3,84.21000000000001,4,2,3,9,Loyal Customers
12828,2,6,154.8,4,4,4,12,Champions
12829,322,3,55.85000000000001,1,2,3,6,Potential Customers
12830,37,7,1723.68,3,4,4,11,Champions
12831,262,1,34.199999999999996,1,1,2,4,At Risk
12832,32,2,19.9,3,2,2,7,Loyal Customers
12833,145,1,15.0,1,1,1,3,At Risk
12834,282,1,15.9,1,1,2,4,At Risk
12836,59,4,29.05,2,3,2,7,Loyal Customers
12837,173,1,17.0,1,1,2,4,At Risk
12838,33,2,11.4,3,2,1,6,Potential Customers
12839,2,16,226.11,4,4,4,12,Champions
12840,143,6,127.75,2,4,4,10,Champions
12841,4,26,327.06,4,4,4,12,Champions
12842,70,2,22.8,2,2,2,6,Potential Customers
12843,65,9,119.3,2,4,4,10,Champions
12844,29,2,8.7,3,2,1,6,Potential Customers
12845,267,4,284.79999999999995,1,3,4,8,Loyal Customers
12847,22,1,1.17,3,1,1,5,Potential Customers
12849,31,2,44.699999999999996,3,2,3,8,Loyal Customers
12851,96,1,4.16,2,1,1,4,At Risk
12852,290,2,14.45,1,2,1,4,At Risk
12853,107,9,171.60000000000002,2,4,4,10,Champions
12854,78,5,141.6,2,3,4,9,Loyal Customers
12855,372,1,17.700000000000003,1,1,2,4,At Risk
12856,7,8,29.28,4,4,2,10,Champions
12857,210,2,53.400000000000006,1,2,3,6,Potential Customers
12863,52,2,323.0,2,2,4,8,Loyal Customers
12864,138,1,17.4,2,1,2,5,Potential Customers
12865,26,3,20.38,3,2,2,7,Loyal Customers
12866,283,1,6.3,1,1,1,3,At Risk
12867,26,10,43.04,3,4,3,10,Champions
12868,185,6,123.95,1,4,4,9,Loyal Customers
12870,366,1,-9.95,1,1,1,3,Returned/Churned
12871,84,2,178.2,2,2,4,8,Loyal Customers
12872,326,2,50.0,1,2,3,6,Potential Customers
12873,282,1,68.0,1,1,3,5,Potential Customers
12875,143,2,343.2300000000001,2,2,4,8,Loyal Customers
12876,57,2,86.49999999999999,2,2,3,7,Loyal Customers
12877,3,12,365.79,4,4,4,12,Champions
12878,18,3,36.75,3,2,2,7,Loyal Customers
12879,44,4,189.76999999999998,3,3,4,10,Champions
12881,275,1,195.0,1,1,4,6,Potential Customers
12882,9,2,283.2,4,2,4,10,Champions
12883,24,4,71.85,3,3,3,9,Loyal Customers
12884,88,1,170.0,2,1,4,7,Loyal Customers
12885,63,4,26.450000000000003,2,3,2,7,Loyal Customers
12886,67,3,31.009999999999998,2,2,2,6,Potential Customers
12888,214,4,66.21000000000001,1,3,3,7,Loyal Customers
12890,24,1,10.5,3,1,1,5,Potential Customers
12891,185,3,331.0,1,2,4,7,Loyal Customers
12893,30,1,3.75,3,1,1,5,Potential Customers
12895,42,3,17.8,3,2,2,7,Loyal Customers
12897,204,2,116.0,1,2,4,7,Loyal Customers
12901,8,36,8240.210000000001,4,4,4,12,Champions
12902,264,1,17.700000000000003,1,1,2,4,At Risk
12904,18,2,11.899999999999999,3,2,1,6,Potential Customers
12906,11,5,206.76,4,3,4,11,Champions
12908,58,4,246.0,2,3,4,9,Loyal Customers
12909,39,8,96.79,3,4,3,10,Champions
12910,23,8,362.76,3,4,4,11,Champions
12912,2,5,365.34000000000003,4,3,4,11,Champions
12913,4,5,410.76000000000005,4,3,4,11,Champions
12915,148,2,38.4,1,2,2,5,Potential Customers
12916,138,5,176.9,2,3,4,9,Loyal Customers
12917,128,1,297.0,2,1,4,7,Loyal Customers
12919,8,8,233.64999999999998,4,4,4,12,Champions
12920,17,1,7.95,3,1,1,5,Potential Customers
12921,3,50,927.26,4,4,4,12,Champions
12922,161,1,13.2,1,1,1,3,At Risk
12923,64,1,12.48,2,1,1,4,At Risk
12924,88,5,162.87000000000003,2,3,4,9,Loyal Customers
12925,4,2,25.5,4,2,2,8,Loyal Customers
12928,35,5,127.04,3,3,4,10,Champions
12929,122,2,4.25,2,2,1,5,Potential Customers
12930,78,4,19.299999999999997,2,3,2,7,Loyal Customers
12931,21,20,2859.26,3,4,4,11,Champions
12933,24,4,57.05,3,3,3,9,Loyal Customers
12935,2,8,101.78,4,4,3,11,Champions
12936,17,5,113.14000000000001,3,3,4,10,Champions
12937,15,4,37.95,4,3,2,9,Loyal Customers
12938,25,1,9.48,3,1,1,5,Potential Customers
12939,64,8,1820.96,2,4,4,10,Champions
12940,46,4,9.100000000000001,3,3,1,7,Loyal Customers
12942,131,3,41.25,2,2,3,7,Loyal Customers
12943,301,1,-3.75,1,1,1,3,Returned/Churned
12944,35,2,39.699999999999996,3,2,3,8,Loyal Customers
12945,288,1,25.5,1,1,2,4,At Risk
12947,143,11,57.349999999999994,2,4,3,9,Loyal Customers
12948,16,8,200.4,4,4,4,12,Champions
12949,30,10,95.21000000000001,3,4,3,10,Champions
12950,2,3,143.4,4,2,4,10,Champions
12951,8,8,79.04,4,4,3,11,Champions
12952,5,5,66.36,4,3,3,10,Champions
12953,9,1,35.400000000000006,4,1,2,7,Loyal Customers
12955,1,14,257.03999999999996,4,4,4,12,Champions
12956,306,1,3.75,1,1,1,3,At Risk
12957,4,12,97.01,4,4,3,11,Champions
12962,7,2,37.650000000000006,4,2,2,8,Loyal Customers
12963,8,9,169.55,4,4,4,12,Champions
12965,89,1,8.25,2,1,1,4,At Risk
12966,9,1,15.0,4,1,1,6,Potential Customers
12967,3,4,62.75,4,3,3,10,Champions
12968,112,1,15.0,2,1,1,4,At Risk
12970,7,4,25.05,4,3,2,9,Loyal Customers
12971,3,89,3692.71,4,4,4,12,Champions
12974,197,1,15.9,1,1,2,4,At Risk
12976,211,1,19.8,1,1,2,4,At Risk
12977,156,1,8.5,1,1,1,3,At Risk
12980,155,12,2852.4,1,4,4,9,Loyal Customers
12981,29,2,54.48,3,2,3,8,Loyal Customers
12982,239,2,8.450000000000001,1,2,1,4,At Risk
12984,18,1,30.0,3,1,2,6,Potential Customers
12985,0,3,46.32000000000001,4,2,3,9,Loyal Customers
12987,73,3,31.45,2,2,2,6,Potential Customers
12988,292,1,4.25,1,1,1,3,At Risk
12989,3,19,3276.81,4,4,4,12,Champions
12990,31,3,120.9,3,2,4,9,Loyal Customers
12991,23,2,65.0,3,2,3,8,Loyal Customers
12993,23,4,64.15,3,3,3,9,Loyal Customers
12994,4,5,42.55,4,3,3,10,Champions
12995,77,2,30.740000000000002,2,2,2,6,Potential Customers
12997,22,7,83.78,3,4,3,10,Champions
12999,196,3,107.03999999999999,1,2,3,6,Potential Customers
13000,106,3,107.07000000000001,2,2,3,7,Loyal Customers
13001,4,15,887.37,4,4,4,12,Champions
13002,318,1,15.0,1,1,1,3,At Risk
13003,105,3,98.5,2,3,3,8,Loyal Customers
13004,11,22,218.56,4,4,4,12,Champions
13005,173,3,32.349999999999994,1,3,2,6,Potential Customers
13006,56,1,31.8,2,1,2,5,Potential Customers
13008,323,2,-36.0,1,2,1,4,Returned/Churned
13011,372,1,15.0,1,1,1,3,At Risk
13012,9,11,110.37,4,4,4,12,Champions
13013,1,15,251.5,4,4,4,12,Champions
13014,2,16,404.49999999999994,4,4,4,12,Champions
13015,53,5,113.7,2,3,4,9,Loyal Customers
13016,73,3,64.56,2,3,3,8,Loyal Customers
13017,7,1,204.0,4,1,4,9,Loyal Customers
13018,16,29,547.43,4,4,4,12,Champions
13021,4,12,200.32000000000002,4,4,4,12,Champions
13023,64,2,47.7,2,2,3,7,Loyal Customers
13026,1,8,205.34999999999997,4,4,4,12,Champions
13027,113,6,1632.0,2,4,4,10,Champions
13028,22,3,28.889999999999997,3,3,2,8,Loyal Customers
13029,30,3,1131.0,3,3,4,10,Champions
13030,11,2,6.6899999999999995,4,2,1,7,Loyal Customers
13032,38,3,14.84,3,3,1,7,Loyal Customers
13033,357,1,19.5,1,1,2,4,At Risk
13034,54,2,34.8,2,2,2,6,Potential Customers
13035,57,3,112.8,2,3,4,9,Loyal Customers
13037,138,3,38.400000000000006,2,3,2,7,Loyal Customers
13038,80,3,219.0,2,3,4,9,Loyal Customers
13040,8,2,21.84,4,2,2,8,Loyal Customers
13043,253,2,14.950000000000003,1,2,1,4,At Risk
13044,291,1,12.600000000000001,1,1,1,3,At Risk
13045,99,1,17.4,2,1,2,5,Potential Customers
13046,30,2,39.71,3,2,3,8,Loyal Customers
13047,31,18,155.08,3,4,4,11,Champions
13048,14,5,17.5,4,3,2,9,Loyal Customers
13049,64,2,106.19999999999999,2,2,3,7,Loyal Customers
13050,9,28,229.12,4,4,4,12,Champions
13052,212,1,23.85,1,1,2,4,At Risk
13055,64,4,34.78,2,3,2,7,Loyal Customers
13058,24,3,172.8,3,3,4,10,Champions
13059,249,1,17.700000000000003,1,1,2,4,At Risk
13060,253,1,35.400000000000006,1,1,2,4,At Risk
13061,72,1,9.959999999999999,2,1,1,4,At Risk
13062,191,1,60.48,1,1,3,5,Potential Customers
13064,12,4,85.65,4,3,3,10,Champions
13065,373,1,17.4,1,1,2,4,At Risk
13066,24,3,-9.699999999999996,3,3,1,7,Returned/Churned
13067,82,1,7.95,2,1,1,4,At Risk
13068,10,2,344.0,4,2,4,10,Champions
13069,0,27,222.54,4,4,4,12,Champions
13070,192,1,20.8,1,1,2,4,At Risk
13072,266,1,15.0,1,1,1,3,At Risk
13075,129,1,47.2,2,1,3,6,Potential Customers
13077,1,4,32.45,4,3,2,9,Loyal Customers
13078,1,43,1111.6000000000001,4,4,4,12,Champions
13079,4,5,202.4,4,3,4,11,Champions
13080,179,1,3.3600000000000003,1,1,1,3,At Risk
13081,1,21,74.20000000000002,4,4,3,11,Champions
13082,126,10,244.5,2,4,4,10,Champions
13083,4,2,51.0,4,2,3,9,Loyal Customers
13085,157,3,64.4,1,3,3,7,Loyal Customers
13089,2,118,4192.139999999999,4,4,4,12,Champions
13090,8,18,555.66,4,4,4,12,Champions
13091,21,2,16.450000000000003,3,2,2,7,Loyal Customers
13092,70,6,66.1,2,4,3,9,Loyal Customers
13093,267,13,752.85,1,4,4,9,Loyal Customers
13094,21,16,816.24,3,4,4,11,Champions
13095,70,1,9.36,2,1,1,4,At Risk
13097,32,14,247.31,3,4,4,11,Champions
13098,1,41,1670.77,4,4,4,12,Champions
13099,99,1,207.35999999999999,2,1,4,7,Loyal Customers
13101,234,1,9.95,1,1,1,3,At Risk
13102,1,27,765.4399999999999,4,4,4,12,Champions
13103,39,1,51.0,3,1,3,7,Loyal Customers
13104,3,6,434.64,4,4,4,12,Champions
13106,128,2,59.5,2,2,3,7,Loyal Customers
13107,44,5,160.35999999999999,3,3,4,10,Champions
13108,372,1,34.8,1,1,2,4,At Risk
13109,2,5,5.800000000000001,4,3,1,8,Loyal Customers
13110,31,8,51.99,3,4,3,10,Champions
13113,0,40,2258.67,4,4,4,12,Champions
13115,8,14,3.150000000000002,4,4,1,9,Loyal Customers
13116,117,2,9.55,2,2,1,5,Potential Customers
13117,21,8,108.86,3,4,3,10,Champions
13118,19,7,76.80999999999999,3,4,3,10,Champions
13120,238,1,30.599999999999998,1,1,2,4,At Risk
13121,269,2,-2.55,1,2,1,4,Returned/Churned
13122,94,2,48.56999999999999,2,2,3,7,Loyal Customers
13124,89,3,52.5,2,3,3,8,Loyal Customers
13126,4,10,98.72,4,4,3,11,Champions
13127,77,1,34.68,2,1,2,5,Potential Customers
13130,94,1,39.0,2,1,2,5,Potential Customers
13131,23,4,20.9,3,3,2,8,Loyal Customers
13132,261,1,15.299999999999999,1,1,2,4,At Risk
13133,273,2,29.75,1,2,2,5,Potential Customers
13134,72,7,91.99,2,4,3,9,Loyal Customers
13135,196,1,3096.0,1,1,4,6,Potential Customers
13136,50,11,92.57000000000001,3,4,3,10,Champions
13137,10,9,-13.489999999999998,4,4,1,9,Returned/Churned
13138,22,6,91.82000000000001,3,4,3,10,Champions
13139,16,8,328.69,4,4,4,12,Champions
13140,108,3,35.15,2,3,2,7,Loyal Customers
13141,84,6,81.75,2,4,3,9,Loyal Customers
13142,19,1,20.16,3,1,2,6,Potential Customers
13144,332,1,63.75,1,1,3,5,Potential Customers
13145,39,5,573.85,3,3,4,10,Champions
13146,26,1,10.08,3,1,1,5,Potential Customers
13147,10,4,712.8000000000001,4,3,4,11,Champions
13148,29,17,152.08,3,4,4,11,Champions
13149,14,4,87.24000000000001,4,3,3,10,Champions
13151,203,2,12.899999999999999,1,2,1,4,At Risk
13153,5,1,6.24,4,1,1,6,Potential Customers
13154,144,1,-611.86,1,1,1,3,Returned/Churned
13155,33,4,71.85,3,3,3,9,Loyal Customers
13157,49,5,48.89,3,3,3,9,Loyal Customers
13158,94,4,80.1,2,3,3,8,Loyal Customers
13159,8,5,-17.940000000000012,4,3,1,8,Returned/Churned
13160,22,1,15.0,3,1,1,5,Potential Customers
13161,313,1,27.0,1,1,2,4,At Risk
13162,122,5,11.67,2,3,1,6,Potential Customers
13165,46,2,80.16,3,2,3,8,Loyal Customers
13166,282,2,0.0,1,2,1,4,Returned/Churned
13167,18,4,98.58,3,3,3,9,Loyal Customers
13168,36,5,27.9,3,3,2,8,Loyal Customers
13169,63,2,39.300000000000004,2,2,2,6,Potential Customers
13170,26,1,6.75,3,1,1,5,Potential Customers
13171,8,5,-8.440000000000001,4,3,1,8,Returned/Churned
13173,4,2,15.149999999999999,4,2,2,8,Loyal Customers
13174,16,3,36.099999999999994,4,3,2,9,Loyal Customers
13176,46,1,0.85,3,1,1,5,Potential Customers
13177,64,1,17.700000000000003,2,1,2,5,Potential Customers
13178,26,11,361.98,3,4,4,11,Champions
13182,45,1,10.5,3,1,1,5,Potential Customers
13183,7,9,175.9,4,4,4,12,Champions
13184,14,12,19.700000000000003,4,4,2,10,Champions
13185,267,1,71.4,1,1,3,5,Potential Customers
13186,39,5,61.78,3,3,3,9,Loyal Customers
13187,337,1,1.25,1,1,1,3,At Risk
13188,11,1,99.60000000000001,4,1,3,8,Loyal Customers
13189,18,2,19.0,3,2,2,7,Loyal Customers
13192,95,2,41.1,2,2,3,7,Loyal Customers
13193,61,1,2.9,2,1,1,4,At Risk
13194,135,1,34.0,2,1,2,5,Potential Customers
13196,11,4,73.65,4,3,3,10,Champions
13198,10,8,96.60000000000001,4,4,3,11,Champions
13199,3,39,3719.6,4,4,4,12,Champions
13200,19,4,117.45,3,3,4,10,Champions
13203,9,4,56.879999999999995,4,3,3,10,Champions
13207,15,2,42.120000000000005,4,2,3,9,Loyal Customers
13208,58,7,37.419999999999995,2,4,2,8,Loyal Customers
13209,30,11,206.01,3,4,4,11,Champions
13210,93,1,25.5,2,1,2,5,Potential Customers
13211,10,3,223.2,4,3,4,11,Champions
13212,9,4,7.6000000000000005,4,3,1,8,Loyal Customers
13213,56,6,135.57000000000002,2,4,4,10,Champions
13216,267,1,69.12,1,1,3,5,Potential Customers
13217,122,5,52.49999999999999,2,3,3,8,Loyal Customers
13218,127,1,15.0,2,1,1,4,At Risk
13220,78,4,344.1,2,3,4,9,Loyal Customers
13221,240,2,20.3,1,2,2,5,Potential Customers
13223,200,2,115.80000000000001,1,2,4,7,Loyal Customers
13224,60,3,14.22,2,3,1,6,Potential Customers
13225,3,8,1589.3999999999999,4,4,4,12,Champions
13226,273,1,9.95,1,1,1,3,At Risk
13227,201,1,67.5,1,1,3,5,Potential Customers
13228,81,1,179.0,2,1,4,7,Loyal Customers
13229,225,1,15.0,1,1,1,3,At Risk
13230,4,15,9.6,4,4,1,9,Loyal Customers
13232,12,7,75.3,4,4,3,11,Champions
13233,74,2,60.839999999999996,2,2,3,7,Loyal Customers
13235,211,2,-910.1,1,2,1,4,Returned/Churned
13236,24,3,47.08,3,3,3,9,Loyal Customers
13238,11,5,139.8,4,3,4,11,Champions
13239,261,1,18.96,1,1,2,4,At Risk
13240,96,4,42.85,2,3,3,8,Loyal Customers
13242,112,3,62.400000000000006,2,3,3,8,Loyal Customers
13243,203,1,5.1,1,1,1,3,At Risk
13244,92,1,4.95,2,1,1,4,At Risk
13245,50,1,24.900000000000002,3,1,2,6,Potential Customers
13246,18,7,188.43,3,4,4,11,Champions
13247,17,4,119.55000000000001,3,3,4,10,Champions
13248,124,2,33.36,2,2,2,6,Potential Customers
13249,92,3,302.03999999999996,2,3,4,9,Loyal Customers
13253,156,2,42.36,1,2,3,6,Potential Customers
13255,3,3,22.75,4,3,2,9,Loyal Customers
13256,14,1,0.0,4,1,1,6,Returned/Churned
13258,11,3,25.34,4,3,2,9,Loyal Customers
13259,61,1,8.5,2,1,1,4,At Risk
13260,61,1,19.92,2,1,2,5,Potential Customers
13261,268,2,234.0,1,2,4,7,Loyal Customers
13262,263,1,6.959999999999999,1,1,1,3,At Risk
13263,1,35,190.73,4,4,4,12,Champions
13265,53,5,166.48,2,3,4,9,Loyal Customers
13266,11,19,319.01,4,4,4,12,Champions
13267,2,27,253.10999999999999,4,4,4,12,Champions
13268,17,15,44.7,3,4,3,10,Champions
13269,1,17,274.38,4,4,4,12,Champions
13270,366,1,590.0,1,1,4,6,Potential Customers
13271,37,2,-4.29,3,2,1,6,Returned/Churned
13272,31,2,36.660000000000004,3,2,2,7,Loyal Customers
13273,113,1,24.900000000000002,2,1,2,5,Potential Customers
13276,63,2,58.2,2,2,3,7,Loyal Customers
13277,15,4,149.0,4,3,4,11,Champions
13278,40,1,10.5,3,1,1,5,Potential Customers
13279,64,2,0.8599999999999994,2,2,1,5,Potential Customers
13280,122,3,47.75,2,3,3,8,Loyal Customers
13282,18,6,54.90000000000002,3,4,3,10,Champions
13283,59,2,29.3,2,2,2,6,Potential Customers
13284,322,2,20.46,1,2,2,5,Potential Customers
13285,23,4,57.4,3,3,3,9,Loyal Customers
13291,155,1,12.450000000000001,1,1,1,3,At Risk
13292,38,2,65.1,3,2,3,8,Loyal Customers
13294,189,2,42.0,1,2,3,6,Potential Customers
13295,359,2,16.549999999999997,1,2,2,5,Potential Customers
13296,137,1,15.0,2,1,1,4,At Risk
13297,7,4,164.34,4,3,4,11,Champions
13298,1,1,90.0,4,1,3,8,Loyal Customers
13299,268,1,29.700000000000003,1,1,2,4,At Risk
13300,164,2,18.05,1,2,2,5,Potential Customers
13301,103,4,65.52,2,3,3,8,Loyal Customers
13302,155,1,63.75,1,1,3,5,Potential Customers
13304,351,1,12.600000000000001,1,1,1,3,At Risk
13305,4,10,224.89,4,4,4,12,Champions
13307,120,1,15.0,2,1,1,4,At Risk
13308,22,4,50.61,3,3,3,9,Loyal Customers
13309,7,5,79.64,4,3,3,10,Champions
13310,8,6,1.2199999999999989,4,4,1,9,Loyal Customers
13311,4,2,34.54,4,2,2,8,Loyal Customers
13313,22,5,67.78,3,3,3,9,Loyal Customers
13314,1,4,31.08,4,3,2,9,Loyal Customers
13316,37,5,246.69,3,3,4,10,Champions
13317,64,9,102.85000000000001,2,4,3,9,Loyal Customers
13318,1,3,197.88,4,3,4,11,Champions
13319,5,36,570.35,4,4,4,12,Champions
13320,70,6,19.549999999999997,2,4,2,8,Loyal Customers
13321,72,2,259.04,2,2,4,8,Loyal Customers
13322,17,1,8.3,3,1,1,5,Potential Customers
13323,3,5,424.8,4,3,4,11,Champions
13324,32,12,999.0500000000001,3,4,4,11,Champions
13325,81,1,16.5,2,1,2,5,Potential Customers
13327,38,9,427.1,3,4,4,11,Champions
13328,316,1,19.799999999999997,1,1,2,4,At Risk
13329,31,4,41.999999999999986,3,3,3,9,Loyal Customers
13330,92,3,56.28,2,3,3,8,Loyal Customers
13332,14,1,17.0,4,1,2,7,Loyal Customers
13334,82,3,47.8,2,3,3,8,Loyal Customers
13336,77,1,15.299999999999999,2,1,2,5,Potential Customers
13338,154,3,-16.700000000000003,1,3,1,5,Returned/Churned
13339,200,1,17.4,1,1,2,4,At Risk
13340,45,7,830.08,3,4,4,11,Champions
13341,260,1,87.6,1,1,3,5,Potential Customers
13343,172,2,8.3,1,2,1,4,At Risk
13344,67,3,79.64,2,3,3,8,Loyal Customers
13345,276,2,15.750000000000004,1,2,2,5,Potential Customers
13347,70,1,39.599999999999994,2,1,3,6,Potential Customers
13348,64,1,10.2,2,1,1,4,At Risk
13349,10,1,15.600000000000001,4,1,2,7,Loyal Customers
13350,16,3,68.6,4,3,3,10,Champions
13351,66,1,50.0,2,1,3,6,Potential Customers
13352,7,2,7.2,4,2,1,7,Loyal Customers
13354,71,1,10.5,2,1,1,4,At Risk
13355,122,1,17.700000000000003,2,1,2,5,Potential Customers
13356,80,1,17.4,2,1,2,5,Potential Customers
13357,257,1,9.9,1,1,1,3,At Risk
13358,268,1,17.9,1,1,2,4,At Risk
13359,59,2,41.7,2,2,3,7,Loyal Customers
13362,3,5,83.64999999999999,4,3,3,10,Champions
13363,17,2,34.5,3,2,2,7,Loyal Customers
13364,66,2,13.360000000000001,2,2,1,5,Potential Customers
13365,8,3,61.85,4,3,3,10,Champions
13366,50,1,56.160000000000004,3,1,3,7,Loyal Customers
13368,256,2,45.480000000000004,1,2,3,6,Potential Customers
13369,354,2,28.1,1,2,2,5,Potential Customers
13370,366,2,24.35,1,2,2,5,Potential Customers
13372,89,1,9.95,2,1,1,4,At Risk
13373,60,3,54.6,2,3,3,8,Loyal Customers
13375,81,2,10.75,2,2,1,5,Potential Customers
13376,99,3,65.69999999999999,2,3,3,8,Loyal Customers
13379,26,3,12.24,3,3,1,7,Loyal Customers
13381,21,7,129.22,3,4,4,11,Champions
13382,280,1,15.0,1,1,1,3,At Risk
13384,30,9,163.3,3,4,4,11,Champions
13385,329,1,17.700000000000003,1,1,2,4,At Risk
13388,121,3,-23.85,2,3,1,6,Returned/Churned
13389,11,3,35.16,4,3,2,9,Loyal Customers
13390,74,1,15.0,2,1,1,4,At Risk
13391,203,1,59.8,1,1,3,5,Potential Customers
13394,1,10,132.17000000000002,4,4,4,12,Champions
13395,185,1,1.92,1,1,1,3,At Risk
13396,21,4,33.96,3,3,2,8,Loyal Customers
13397,72,6,363.5,2,4,4,10,Champions
13398,192,1,9.959999999999999,1,1,1,3,At Risk
13402,127,2,34.85,2,2,2,6,Potential Customers
13403,17,1,15.0,3,1,1,5,Potential Customers
13404,1,2,32.34,4,2,2,8,Loyal Customers
13405,74,3,66.0,2,3,3,8,Loyal Customers
13408,1,81,4152.55,4,4,4,12,Champions
13410,8,7,198.45,4,4,4,12,Champions
13411,107,1,18.75,2,1,2,5,Potential Customers
13414,133,3,454.65,2,3,4,9,Loyal Customers
13416,43,2,97.7,3,2,3,8,Loyal Customers
13417,4,2,41.2,4,2,3,9,Loyal Customers
13418,11,23,179.10000000000002,4,4,4,12,Champions
13419,63,1,10.5,2,1,1,4,At Risk
13420,134,4,14.700000000000001,2,3,1,6,Potential Customers
13421,40,3,34.95,3,3,2,8,Loyal Customers
13422,51,2,-11.549999999999999,2,2,1,5,Returned/Churned
13425,108,3,41.7,2,3,3,8,Loyal Customers
13426,0,12,239.74,4,4,4,12,Champions
13427,19,3,44.22,3,3,3,9,Loyal Customers
13428,10,1,0.65,4,1,1,6,Potential Customers
13429,10,4,69.4,4,3,3,10,Champions
13430,18,4,48.88,3,3,3,9,Loyal Customers
13431,67,2,53.8,2,2,3,7,Loyal Customers
13434,74,2,187.08,2,2,4,8,Loyal Customers
13435,5,9,208.92000000000002,4,4,4,12,Champions
13436,1,1,11.7,4,1,1,6,Potential Customers
13437,14,7,106.75999999999999,4,4,3,11,Champions
13439,255,1,6.5,1,1,1,3,At Risk
13441,91,1,12.600000000000001,2,1,1,4,At Risk
13447,23,4,28.4,3,3,2,8,Loyal Customers
13448,16,10,0.9099999999999966,4,4,1,9,Loyal Customers
13449,23,1,20.4,3,1,2,6,Potential Customers
13450,26,6,113.76,3,4,4,11,Champions
13451,26,6,-22.349999999999994,3,4,1,8,Returned/Churned
13452,259,2,590.0,1,2,4,7,Loyal Customers
13453,165,2,43.7,1,2,3,6,Potential Customers
13455,24,4,21.599999999999998,3,3,2,8,Loyal Customers
13456,17,7,330.00000000000006,3,4,4,11,Champions
13458,7,22,335.21000000000004,4,4,4,12,Champions
13460,29,2,22.98,3,2,2,7,Loyal Customers
13461,38,3,156.1,3,3,4,10,Champions
13462,183,2,11.55,1,2,1,4,At Risk
13464,58,1,10.5,2,1,1,4,At Risk
13466,100,2,7.7500000000000036,2,2,1,5,Potential Customers
13467,10,2,18.56,4,2,2,8,Loyal Customers
13468,1,41,815.25,4,4,4,12,Champions
13470,99,2,33.0,2,2,2,6,Potential Customers
13471,1,4,71.9,4,3,3,10,Champions
13473,60,3,27.78,2,3,2,7,Loyal Customers
13474,236,1,1.7,1,1,1,3,At Risk
13475,191,4,78.18,1,3,3,7,Loyal Customers
13476,178,4,-94.25,1,3,1,5,Returned/Churned
13477,37,8,107.27,3,4,3,10,Champions
13479,198,3,40.45,1,3,3,7,Loyal Customers
13481,45,8,54.400000000000006,3,4,3,10,Champions
13482,232,1,17.4,1,1,2,4,At Risk
13483,65,1,10.08,2,1,1,4,At Risk
13484,241,1,67.5,1,1,3,5,Potential Customers
13485,233,1,12.5,1,1,1,3,At Risk
13486,78,3,40.620000000000005,2,3,3,8,Loyal Customers
13487,57,3,53.099999999999994,2,3,3,8,Loyal Customers
13488,17,17,201.73,3,4,4,11,Champions
13489,105,4,259.2,2,3,4,9,Loyal Customers
13491,51,10,151.38,2,4,4,10,Champions
13492,136,3,41.4,2,3,3,8,Loyal Customers
13493,275,2,198.0,1,2,4,7,Loyal Customers
13494,311,1,20.16,1,1,2,4,At Risk
13495,7,6,131.53,4,4,4,12,Champions
13496,10,3,-3.4000000000000057,4,3,1,8,Returned/Churned
13497,282,3,24.75,1,3,2,6,Potential Customers
13499,17,7,175.99,3,4,4,11,Champions
13500,23,4,30.55,3,3,2,8,Loyal Customers
13501,242,2,-19.65,1,2,1,4,Returned/Churned
13502,16,3,39.12,4,3,2,9,Loyal Customers
13503,71,1,10.5,2,1,1,4,At Risk
13504,64,1,14.850000000000001,2,1,1,4,At Risk
13505,67,8,68.86,2,4,3,9,Loyal Customers
13506,312,3,33.65,1,3,2,6,Potential Customers
13507,3,4,79.05,4,3,3,10,Champions
13508,243,1,15.9,1,1,2,4,At Risk
13509,8,7,223.9,4,4,4,12,Champions
13510,1,5,44.379999999999995,4,3,3,10,Champions
13512,260,1,17.85,1,1,2,4,At Risk
13513,126,1,9.899999999999999,2,1,1,4,At Risk
13514,73,1,39.900000000000006,2,1,3,6,Potential Customers
13515,72,4,80.34,2,3,3,8,Loyal Customers
13516,21,3,230.34,3,3,4,10,Champions
13517,59,5,35.25,2,3,2,7,Loyal Customers
13518,85,1,19.799999999999997,2,1,2,5,Potential Customers
13519,50,2,-0.049999999999998934,3,2,1,6,Returned/Churned
13520,58,8,285.3,2,4,4,10,Champions
13521,1,3,11.16,4,3,1,8,Loyal Customers
13522,30,1,17.700000000000003,3,1,2,6,Potential Customers
13523,33,6,94.03,3,4,3,10,Champions
13524,40,5,175.20000000000002,3,3,4,10,Champions
13525,14,2,464.0,4,2,4,10,Champions
13527,33,8,109.76,3,4,3,10,Champions
13529,78,2,33.2,2,2,2,6,Potential Customers
13531,205,2,54.3,1,2,3,6,Potential Customers
13532,33,1,2.08,3,1,1,5,Potential Customers
13533,182,3,11.75,1,3,1,5,Potential Customers
13534,2,43,412.42,4,4,4,12,Champions
13536,1,7,144.57999999999998,4,4,4,12,Champions
13538,43,7,309.6,3,4,4,11,Champions
13539,85,4,21.400000000000002,2,3,2,7,Loyal Customers
13544,39,2,10.7,3,2,1,6,Potential Customers
13546,12,3,31.45,4,3,2,9,Loyal Customers
13548,96,2,11.049999999999999,2,2,1,5,Potential Customers
13549,25,8,136.12,3,4,4,11,Champions
13551,319,1,17.85,1,1,2,4,At Risk
13552,66,16,218.07,2,4,4,10,Champions
13555,73,4,166.9,2,3,4,9,Loyal Customers
13557,28,2,49.8,3,2,3,8,Loyal Customers
13558,5,4,17.7,4,3,2,9,Loyal Customers
13560,7,1,2.95,4,1,1,6,Potential Customers
13561,215,1,2.08,1,1,1,3,At Risk
13562,81,3,53.650000000000006,2,3,3,8,Loyal Customers
13563,84,2,94.35,2,2,3,7,Loyal Customers
13564,144,5,-530.6899999999999,1,3,1,5,Returned/Churned
13565,19,2,11.0,3,2,1,6,Potential Customers
13566,40,2,5.5,3,2,1,6,Potential Customers
13568,173,1,8.3,1,1,1,3,At Risk
13569,17,2,8.7,3,2,1,6,Potential Customers
13570,243,1,3.9,1,1,1,3,At Risk
13571,12,12,100.29,4,4,3,11,Champions
13572,205,1,17.700000000000003,1,1,2,4,At Risk
13573,50,2,41.67,3,2,3,8,Loyal Customers
13575,23,5,99.61,3,3,3,9,Loyal Customers
13576,10,20,1720.5600000000002,4,4,4,12,Champions
13577,25,5,77.9,3,3,3,9,Loyal Customers
13579,14,2,66.30000000000001,4,2,3,9,Loyal Customers
13581,309,1,7.95,1,1,1,3,At Risk
13583,155,1,9.0,1,1,1,3,At Risk
13584,306,1,9.95,1,1,1,3,At Risk
13587,31,3,-309.0,3,3,1,7,Returned/Churned
13588,15,13,77.25999999999999,4,4,3,11,Champions
13589,14,2,39.95,4,2,3,9,Loyal Customers
13590,11,7,358.09,4,4,4,12,Champions
13591,64,3,57.120000000000005,2,3,3,8,Loyal Customers
13592,35,4,79.07,3,3,3,9,Loyal Customers
13593,108,6,14.0,2,4,1,7,Loyal Customers
13594,52,1,9.9,2,1,1,4,At Risk
13596,5,2,21.78,4,2,2,8,Loyal Customers
13598,47,2,-11.5,3,2,1,6,Returned/Churned
13599,1,33,447.01000000000005,4,4,4,12,Champions
13600,312,1,4.95,1,1,1,3,At Risk
13601,45,2,19.45,3,2,2,7,Loyal Customers
13602,64,1,16.5,2,1,2,5,Potential Customers
13603,26,1,6.24,3,1,1,5,Potential Customers
13606,29,3,52.19,3,3,3,9,Loyal Customers
13607,40,1,23.4,3,1,2,6,Potential Customers
13610,12,9,46.34,4,4,3,11,Champions
13611,89,4,69.35000000000001,2,3,3,8,Loyal Customers
13614,24,4,50.040000000000006,3,3,3,9,Loyal Customers
13615,312,2,5.549999999999997,1,2,1,4,At Risk
13617,40,3,23.65,3,3,2,8,Loyal Customers
13618,173,1,6.959999999999999,1,1,1,3,At Risk
13621,116,1,4.0,2,1,1,4,At Risk
13623,30,7,-0.6099999999999959,3,4,1,8,Returned/Churned
13626,252,1,17.4,1,1,2,4,At Risk
13627,59,7,70.03,2,4,3,9,Loyal Customers
13629,23,11,1958.85,3,4,4,11,Champions
13630,5,11,400.1,4,4,4,12,Champions
13631,99,12,3021.77,2,4,4,10,Champions
13632,24,6,68.62,3,4,3,10,Champions
13634,33,5,27.04,3,3,2,8,Loyal Customers
13635,67,1,17.4,2,1,2,5,Potential Customers
13636,36,6,97.85,3,4,3,10,Champions
13637,52,3,17.849999999999998,2,3,2,7,Loyal Customers
13638,15,1,10.5,4,1,1,6,Potential Customers
13639,74,1,23.4,2,1,2,5,Potential Customers
13642,215,1,4.25,1,1,1,3,At Risk
13643,31,3,39.5,3,3,2,8,Loyal Customers
13644,8,5,58.34,4,3,3,10,Champions
13645,120,1,19.9,2,1,2,5,Potential Customers
13647,9,5,70.36,4,3,3,10,Champions
13649,256,2,17.2,1,2,2,5,Potential Customers
13650,16,7,83.24000000000001,4,4,3,11,Champions
13651,35,2,28.5,3,2,2,7,Loyal Customers
13652,45,3,55.04,3,3,3,9,Loyal Customers
13654,43,6,159.2,3,4,4,11,Champions
13655,114,2,45.8,2,2,3,7,Loyal Customers
13656,164,2,12.75,1,2,1,4,At Risk
13657,10,2,22.8,4,2,2,8,Loyal Customers
13658,9,7,-46.06999999999999,4,4,1,9,Returned/Churned
13659,197,3,67.6,1,3,3,7,Loyal Customers
13662,85,7,51.199999999999996,2,4,3,9,Loyal Customers
13663,179,1,16.5,1,1,2,4,At Risk
13666,60,3,39.8,2,3,3,8,Loyal Customers
13667,149,1,4.16,1,1,1,3,At Risk
13668,2,29,277.28000000000003,4,4,4,12,Champions
13669,50,2,17.55,3,2,2,7,Loyal Customers
13670,75,1,16.5,2,1,2,5,Potential Customers
13672,301,6,-47.16,1,4,1,6,Returned/Churned
13673,18,2,31.2,3,2,2,7,Loyal Customers
13675,151,2,54.96,1,2,3,6,Potential Customers
13678,151,1,4.8,1,1,1,3,At Risk
13680,1,5,-174.15,4,3,1,8,Returned/Churned
13681,17,4,55.61,3,3,3,9,Loyal Customers
13682,187,1,25.5,1,1,2,4,At Risk
13684,285,2,0.0,1,2,1,4,Returned/Churned
13685,2,7,1781.62,4,4,4,12,Champions
13686,182,1,8.5,1,1,1,3,At Risk
13689,63,1,179.0,2,1,4,7,Loyal Customers
13690,59,1,10.2,2,1,1,4,At Risk
13692,24,5,53.45,3,3,3,9,Loyal Customers
13693,325,2,-14.2,1,2,1,4,Returned/Churned
13694,3,60,6389.1,4,4,4,12,Champions
13695,31,15,530.63,3,4,4,11,Champions
13697,38,1,15.0,3,1,1,5,Potential Customers
13699,155,1,17.700000000000003,1,1,2,4,At Risk
13700,26,10,238.83,3,4,4,11,Champions
13703,318,1,99.5,1,1,3,5,Potential Customers
13704,5,10,163.93,4,4,4,12,Champions
13705,7,3,51.599999999999994,4,3,3,10,Champions
13706,302,1,7.800000000000001,1,1,1,3,At Risk
13707,267,2,25.2,1,2,2,5,Potential Customers
13708,271,1,4.949999999999999,1,1,1,3,At Risk
13709,3,17,403.16,4,4,4,12,Champions
13710,31,1,19.799999999999997,3,1,2,6,Potential Customers
13711,218,2,55.400000000000006,1,2,3,6,Potential Customers
13712,246,1,15.0,1,1,1,3,At Risk
13715,281,8,27.189999999999998,1,4,2,7,Loyal Customers
13716,269,1,7.5,1,1,1,3,At Risk
13717,32,7,48.239999999999995,3,4,3,10,Champions
13718,246,2,38.099999999999994,1,2,2,5,Potential Customers
13719,15,5,83.25,4,3,3,10,Champions
13720,116,4,144.5,2,3,4,9,Loyal Customers
13721,36,1,9.48,3,1,1,5,Potential Customers
13722,120,4,72.38,2,3,3,8,Loyal Customers
13723,217,1,47.2,1,1,3,5,Potential Customers
13725,49,11,223.65,3,4,4,11,Champions
13726,38,2,26.52,3,2,2,7,Loyal Customers
13727,28,2,29.85,3,2,2,7,Loyal Customers
13728,36,6,89.24000000000001,3,4,3,10,Champions
13730,135,2,37.8,2,2,2,6,Potential Customers
13731,219,2,34.5,1,2,2,5,Potential Customers
13732,28,1,14.22,3,1,1,5,Potential Customers
13735,24,8,16.800000000000004,3,4,2,9,Loyal Customers
13736,5,3,8.99,4,3,1,8,Loyal Customers
13737,200,1,73.94999999999999,1,1,3,5,Potential Customers
13739,18,1,41.7,3,1,3,7,Loyal Customers
13740,240,1,5.04,1,1,1,3,At Risk
13741,71,4,79.75,2,3,3,8,Loyal Customers
13742,16,14,220.6,4,4,4,12,Champions
13743,2,8,185.75,4,4,4,12,Champions
13744,95,2,22.68,2,2,2,6,Potential Customers
13745,151,2,0.5,1,2,1,4,At Risk
13747,373,1,79.6,1,1,3,5,Potential Customers
13748,95,5,255.41,2,3,4,9,Loyal Customers
13750,53,5,923.61,2,3,4,9,Loyal Customers
13751,288,1,165.0,1,1,4,6,Potential Customers
13752,124,6,203.55,2,4,4,10,Champions
13753,287,1,15.0,1,1,1,3,At Risk
13754,151,2,30.6,1,2,2,5,Potential Customers
13755,3,10,96.51,4,4,3,11,Champions
13756,2,15,708.9200000000001,4,4,4,12,Champions
13758,11,7,308.7,4,4,4,12,Champions
13759,33,2,116.4,3,2,4,9,Loyal Customers
13760,54,2,7.99,2,2,1,5,Potential Customers
13761,50,2,28.4,3,2,2,7,Loyal Customers
13762,204,2,35.27999999999999,1,2,2,5,Potential Customers
13763,63,3,137.22,2,3,4,9,Loyal Customers
13764,70,3,37.34,2,3,2,7,Loyal Customers
13767,2,52,1647.92,4,4,4,12,Champions
13769,2,16,258.09,4,4,4,12,Champions
13771,64,5,187.95,2,3,4,9,Loyal Customers
13772,33,3,67.4,3,3,3,9,Loyal Customers
13774,81,1,19.8,2,1,2,5,Potential Customers
13777,0,41,5939.02,4,4,4,12,Champions
13778,103,1,8.25,2,1,1,4,At Risk
13780,7,2,7.15,4,2,1,7,Loyal Customers
13781,250,1,4.25,1,1,1,3,At Risk
13782,12,6,47.97,4,4,3,11,Champions
13784,9,11,949.3199999999999,4,4,4,12,Champions
13786,367,1,81.6,1,1,3,5,Potential Customers
13787,75,2,29.5,2,2,2,6,Potential Customers
13790,4,1,4.5600000000000005,4,1,1,6,Potential Customers
13791,43,3,397.4,3,3,4,10,Champions
13792,66,2,35.550000000000004,2,2,2,6,Potential Customers
13798,1,63,7831.76,4,4,4,12,Champions
13799,116,2,60.9,2,2,3,7,Loyal Customers
13800,309,1,30.0,1,1,2,4,At Risk
13801,66,1,9.95,2,1,1,4,At Risk
13802,138,6,-126.85,2,4,1,7,Returned/Churned
13803,255,1,17.700000000000003,1,1,2,4,At Risk
13804,30,7,147.99,3,4,4,11,Champions
13805,52,2,205.48000000000002,2,2,4,8,Loyal Customers
13806,63,1,65.4,2,1,3,6,Potential Customers
13807,367,1,19.799999999999997,1,1,2,4,At Risk
13808,5,5,181.98,4,3,4,11,Champions
13809,305,1,7.95,1,1,1,3,At Risk
13810,28,4,117.6,3,3,4,10,Champions
13811,183,4,72.0,1,3,3,7,Loyal Customers
13812,42,3,42.48,3,3,3,9,Loyal Customers
13813,39,5,64.7,3,3,3,9,Loyal Customers
13814,56,3,13.600000000000001,2,3,1,6,Potential Customers
13815,22,5,132.45,3,3,4,10,Champions
13816,23,4,66.58,3,3,3,9,Loyal Customers
13817,29,2,38.5,3,2,2,7,Loyal Customers
13819,301,3,54.2,1,3,3,7,Loyal Customers
13821,144,2,31.740000000000002,1,2,2,5,Potential Customers
13822,5,2,12.09,4,2,1,7,Loyal Customers
13823,18,2,50.5,3,2,3,8,Loyal Customers
13824,32,5,313.0,3,3,4,10,Champions
13826,158,2,17.0,1,2,2,5,Potential Customers
13827,57,3,11.1,2,3,1,6,Potential Customers
13828,22,1,14.850000000000001,3,1,1,5,Potential Customers
13829,359,1,-102.0,1,1,1,3,Returned/Churned
13831,16,6,692.3,4,4,4,12,Champions
13832,17,2,6.149999999999999,3,2,1,6,Potential Customers
13833,159,1,15.9,1,1,2,4,At Risk
13835,25,4,81.45,3,3,3,9,Loyal Customers
13837,211,2,18.75,1,2,2,5,Potential Customers
13838,5,4,26.049999999999997,4,3,2,9,Loyal Customers
13841,252,1,85.0,1,1,3,5,Potential Customers
13842,58,9,157.16,2,4,4,10,Champions
13844,11,1,20.8,4,1,2,7,Loyal Customers
13845,64,1,19.799999999999997,2,1,2,5,Potential Customers
13846,24,4,41.1,3,3,3,9,Loyal Customers
13848,92,3,1120.0,2,3,4,9,Loyal Customers
13849,51,2,32.7,2,2,2,6,Potential Customers
13850,88,2,8.729999999999999,2,2,1,5,Potential Customers
13851,95,3,39.699999999999996,2,3,3,8,Loyal Customers
13853,8,2,85.24,4,2,3,9,Loyal Customers
13854,8,29,3062.58,4,4,4,12,Champions
13856,168,5,155.65,1,3,4,8,Loyal Customers
13858,57,1,12.600000000000001,2,1,1,4,At Risk
13859,326,1,3.75,1,1,1,3,At Risk
13860,1,6,91.84,4,4,3,11,Champions
13862,18,10,106.83,3,4,3,10,Champions
13863,245,2,11.48,1,2,1,4,At Risk
13865,58,4,72.2,2,3,3,8,Loyal Customers
13866,74,1,27.04,2,1,2,5,Potential Customers
13867,31,3,45.9,3,3,3,9,Loyal Customers
13868,7,2,2700.0,4,2,4,10,Champions
13869,123,4,38.1,2,3,2,7,Loyal Customers
13870,2,10,152.46,4,4,4,12,Champions
13871,22,14,268.81,3,4,4,11,Champions
13873,119,4,53.7,2,3,3,8,Loyal Customers
13874,358,1,17.85,1,1,2,4,At Risk
13875,53,5,106.96,2,3,3,8,Loyal Customers
13876,63,1,15.0,2,1,1,4,At Risk
13877,86,1,69.6,2,1,3,6,Potential Customers
13878,54,1,60.0,2,1,3,6,Potential Customers
13880,21,13,333.09000000000003,3,4,4,11,Champions
13881,3,22,2779.2000000000003,4,4,4,12,Champions
13882,2,6,27.900000000000006,4,4,2,10,Champions
13883,1,9,11.5,4,4,1,9,Loyal Customers
13884,7,6,72.9,4,4,3,11,Champions
13885,189,2,23.4,1,2,2,5,Potential Customers
13886,71,1,10.2,2,1,1,4,At Risk
13887,204,1,9.959999999999999,1,1,1,3,At Risk
13888,119,2,20.200000000000003,2,2,2,6,Potential Customers
13889,92,1,25.0,2,1,2,5,Potential Customers
13890,1,14,125.36000000000001,4,4,4,12,Champions
13892,26,4,171.84,3,3,4,10,Champions
13893,297,1,15.9,1,1,2,4,At Risk
13894,22,5,50.55,3,3,3,9,Loyal Customers
13895,21,5,77.50000000000001,3,3,3,9,Loyal Customers
13897,50,1,15.0,3,1,1,5,Potential Customers
13898,325,1,10.2,1,1,1,3,At Risk
13899,16,2,68.4,4,2,3,9,Loyal Customers
13900,183,3,37.019999999999996,1,3,2,6,Potential Customers
13901,72,5,126.91,2,3,4,9,Loyal Customers
13904,37,2,32.34,3,2,2,7,Loyal Customers
13908,79,5,74.78,2,3,3,8,Loyal Customers
13911,57,9,200.12,2,4,4,10,Champions
13914,3,3,13.120000000000001,4,3,1,8,Loyal Customers
13917,49,2,17.28,3,2,2,7,Loyal Customers
13918,49,2,99.72,3,2,3,8,Loyal Customers
13919,53,3,44.099999999999994,2,3,3,8,Loyal Customers
13922,351,1,17.700000000000003,1,1,2,4,At Risk
13923,53,1,5.04,2,1,1,4,At Risk
13924,1,11,27.42,4,4,2,10,Champions
13925,36,6,56.2,3,4,3,10,Champions
13926,23,1,35.400000000000006,3,1,2,6,Potential Customers
13927,74,1,16.6,2,1,2,5,Potential Customers
13928,10,4,80.2,4,3,3,10,Champions
13929,169,3,419.4,1,3,4,8,Loyal Customers
13930,57,2,35.6,2,2,2,6,Potential Customers
13931,85,3,267.9,2,3,4,9,Loyal Customers
13932,294,1,17.0,1,1,2,4,At Risk
13933,109,2,40.050000000000004,2,2,3,7,Loyal Customers
13934,263,1,19.799999999999997,1,1,2,4,At Risk
13936,171,2,-11.82,1,2,1,4,Returned/Churned
13937,169,1,30.599999999999998,1,1,2,4,At Risk
13938,35,1,13.28,3,1,1,5,Potential Customers
13939,23,4,51.2,3,3,3,9,Loyal Customers
13940,17,4,82.2,3,3,3,9,Loyal Customers
13941,21,7,189.93,3,4,4,11,Champions
13946,79,3,238.01999999999998,2,3,4,9,Loyal Customers
13947,65,1,13.5,2,1,1,4,At Risk
13948,360,1,46.8,1,1,3,5,Potential Customers
13949,2,6,129.93,4,4,4,12,Champions
13950,11,5,117.17999999999999,4,3,4,11,Champions
13951,176,3,50.1,1,3,3,7,Loyal Customers
13952,211,3,49.019999999999996,1,3,3,7,Loyal Customers
13953,7,7,3019.8,4,4,4,12,Champions
13954,1,3,21.799999999999997,4,3,2,9,Loyal Customers
13955,154,2,55.95,1,2,3,6,Potential Customers
13956,5,5,16.2,4,3,2,9,Loyal Customers
13958,372,1,-15.9,1,1,1,3,Returned/Churned
13959,79,3,58.25,2,3,3,8,Loyal Customers
13960,21,2,35.400000000000006,3,2,2,7,Loyal Customers
13962,21,2,35.5,3,2,2,7,Loyal Customers
13963,308,4,129.3,1,3,4,8,Loyal Customers
13967,145,1,35.7,1,1,2,4,At Risk
13969,7,20,440.88,4,4,4,12,Champions
13971,8,11,111.65,4,4,4,12,Champions
13972,70,2,24.659999999999997,2,2,2,6,Potential Customers
13973,287,1,15.0,1,1,1,3,At Risk
13974,49,1,15.0,3,1,1,5,Potential Customers
13975,31,7,97.94,3,4,3,10,Champions
13976,206,1,69.36,1,1,3,5,Potential Customers
13978,14,2,78.36000000000001,4,2,3,9,Loyal Customers
13979,73,1,20.8,2,1,2,5,Potential Customers
13980,60,1,22.5,2,1,2,5,Potential Customers
13982,39,5,113.55,3,3,4,10,Champions
13983,29,13,795.3,3,4,4,11,Champions
13984,26,6,246.90000000000003,3,4,4,11,Champions
13985,4,16,303.96,4,4,4,12,Champions
13986,17,1,35.400000000000006,3,1,2,6,Potential Customers
13988,19,9,99.58,3,4,3,10,Champions
13989,65,2,39.6,2,2,3,7,Loyal Customers
13990,213,1,23.4,1,1,2,4,At Risk
13991,12,7,56.99,4,4,3,11,Champions
13992,30,1,20.0,3,1,2,6,Potential Customers
13993,32,12,281.8,3,4,4,11,Champions
13994,3,6,134.4,4,4,4,12,Champions
13995,15,6,72.30000000000001,4,4,3,11,Champions
13999,10,15,296.71000000000004,4,4,4,12,Champions
14000,206,2,59.24999999999999,1,2,3,6,Potential Customers
14001,45,4,59.69,3,3,3,9,Loyal Customers
14002,134,2,17.88,2,2,2,6,Potential Customers
14004,43,7,152.05,3,4,4,11,Champions
14005,9,5,265.8,4,3,4,11,Champions
14006,115,3,110.52000000000001,2,3,4,9,Loyal Customers
14009,198,3,44.47,1,3,3,7,Loyal Customers
14012,277,1,37.2,1,1,2,4,At Risk
14013,110,3,36.78,2,3,2,7,Loyal Customers
14014,77,1,15.0,2,1,1,4,At Risk
14015,52,1,108.48,2,1,3,6,Potential Customers
14016,154,5,49.23,1,3,3,7,Loyal Customers
14019,46,4,34.949999999999996,3,3,2,8,Loyal Customers
14020,16,2,49.8,4,2,3,9,Loyal Customers
14021,155,3,98.8,1,3,3,7,Loyal Customers
14022,225,1,10.5,1,1,1,3,At Risk
14023,7,2,32.4,4,2,2,8,Loyal Customers
14024,121,2,35.650000000000006,2,2,2,6,Potential Customers
14027,60,1,17.4,2,1,2,5,Potential Customers
14029,63,2,130.2,2,2,4,8,Loyal Customers
14030,18,8,72.45,3,4,3,10,Champions
14031,7,23,2257.88,4,4,4,12,Champions
14032,2,18,540.4200000000001,4,4,4,12,Champions
14034,22,4,-29.869999999999997,3,3,1,7,Returned/Churned
14035,28,5,241.5,3,3,4,10,Champions
14036,284,1,25.200000000000003,1,1,2,4,At Risk
14037,176,2,25.650000000000002,1,2,2,5,Potential Customers
14038,78,4,56.5,2,3,3,8,Loyal Customers
14039,33,1,69.6,3,1,3,7,Loyal Customers
14040,40,15,299.21000000000004,3,4,4,11,Champions
14041,266,1,0.58,1,1,1,3,At Risk
14044,26,4,28.099999999999998,3,3,2,8,Loyal Customers
14045,109,4,1221.75,2,3,4,9,Loyal Customers
14046,284,1,19.080000000000002,1,1,2,4,At Risk
14047,8,7,124.9,4,4,4,12,Champions
14048,277,2,0.34999999999999964,1,2,1,4,At Risk
14049,16,6,99.4,4,4,3,11,Champions
14050,31,2,35.28,3,2,2,7,Loyal Customers
14051,0,26,1722.45,4,4,4,12,Champions
14052,19,1,2.08,3,1,1,5,Potential Customers
14053,124,2,218.5,2,2,4,8,Loyal Customers
14054,65,1,16.5,2,1,2,5,Potential Customers
14055,106,1,23.9,2,1,2,5,Potential Customers
14056,1,29,248.18,4,4,4,12,Champions
14057,23,18,775.42,3,4,4,11,Champions
14059,266,1,23.4,1,1,2,4,At Risk
14060,4,20,753.64,4,4,4,12,Champions
14062,9,12,1200.8200000000002,4,4,4,12,Champions
14064,29,7,-129.21999999999997,3,4,1,8,Returned/Churned
14066,266,1,17.700000000000003,1,1,2,4,At Risk
14067,63,2,28.0,2,2,2,6,Potential Customers
14068,320,1,29.5,1,1,2,4,At Risk
14071,3,9,85.29,4,4,3,11,Champions
14073,21,2,-1.3000000000000007,3,2,1,6,Returned/Churned
14075,4,3,120.66,4,3,4,11,Champions
14076,129,1,16.95,2,1,2,5,Potential Customers
14077,40,5,66.85,3,3,3,9,Loyal Customers
14078,101,6,324.34,2,4,4,10,Champions
14079,124,1,15.0,2,1,1,4,At Risk
14080,32,1,10.2,3,1,1,5,Potential Customers
14081,267,4,0.9499999999999993,1,3,1,5,Potential Customers
14082,364,1,2.1,1,1,1,3,At Risk
14083,4,9,69.0,4,4,3,11,Champions
14085,2,19,201.23,4,4,4,12,Champions
14087,2,2,-10.59,4,2,1,7,Returned/Churned
14088,10,14,1300.06,4,4,4,12,Champions
14089,56,1,16.5,2,1,2,5,Potential Customers
14090,324,1,76.32000000000001,1,1,3,5,Potential Customers
14092,7,17,299.42,4,4,4,12,Champions
14093,12,1,1.95,4,1,1,6,Potential Customers
14096,4,34,-7899.59,4,4,1,9,Returned/Churned
14098,36,1,8.25,3,1,1,5,Potential Customers
14099,16,12,200.69,4,4,4,12,Champions
14100,137,1,7.95,2,1,1,4,At Risk
14101,73,6,1682.1999999999998,2,4,4,10,Champions
14102,5,8,179.9,4,4,4,12,Champions
14104,154,2,89.16,1,2,3,6,Potential Customers
14105,85,2,22.55,2,2,2,6,Potential Customers
14107,51,8,170.17,2,4,4,10,Champions
14108,30,3,14.13,3,3,1,7,Loyal Customers
14109,23,2,6.5,3,2,1,6,Potential Customers
14110,3,13,1760.24,4,4,4,12,Champions
14111,14,5,327.85,4,3,4,11,Champions
14112,22,12,130.12,3,4,4,11,Champions
14113,3,8,192.55,4,4,4,12,Champions
14114,273,2,107.39999999999999,1,2,3,6,Potential Customers
14116,19,5,82.77,3,3,3,9,Loyal Customers
14117,143,1,30.0,2,1,2,5,Potential Customers
14119,354,1,-19.9,1,1,1,3,Returned/Churned
14121,3,6,47.56999999999999,4,4,3,11,Champions
14124,84,1,90.0,2,1,3,6,Potential Customers
14125,10,3,47.28,4,3,3,10,Champions
14126,7,4,80.2,4,3,3,10,Champions
14127,122,3,23.84,2,3,2,7,Loyal Customers
14128,60,2,14.399999999999999,2,2,1,5,Potential Customers
14129,1,5,93.4,4,3,3,10,Champions
14130,319,1,15.0,1,1,1,3,At Risk
14132,2,12,277.74,4,4,4,12,Champions
14133,129,5,38.22,2,3,2,7,Loyal Customers
14135,1,15,803.0500000000001,4,4,4,12,Champions
14138,1,2,27.42,4,2,2,8,Loyal Customers
14139,46,1,9.36,3,1,1,5,Potential Customers
14140,3,3,24.0,4,3,2,9,Loyal Customers
14141,2,6,109.35000000000001,4,4,3,11,Champions
14142,373,1,17.88,1,1,2,4,At Risk
14143,133,1,17.0,2,1,2,5,Potential Customers
14145,46,5,831.6,3,3,4,10,Champions
14146,8,6,67.67999999999999,4,4,3,11,Champions
14147,49,3,202.6,3,3,4,10,Champions
14148,233,1,127.5,1,1,4,6,Potential Customers
14149,212,3,-8.909999999999997,1,3,1,5,Returned/Churned
14150,35,2,127.20000000000002,3,2,4,9,Loyal Customers
14152,75,3,8.26,2,3,1,6,Potential Customers
14154,239,2,43.2,1,2,3,6,Potential Customers
14155,266,1,17.85,1,1,2,4,At Risk
14156,9,66,4391.24,4,4,4,12,Champions
14157,19,3,-7.700000000000003,3,3,1,7,Returned/Churned
14158,40,1,4.5600000000000005,3,1,1,5,Potential Customers
14159,19,14,71.75,3,4,3,10,Champions
14161,215,3,47.29,1,3,3,7,Loyal Customers
14162,173,2,33.45,1,2,2,5,Potential Customers
14163,87,4,178.3,2,3,4,9,Loyal Customers
14164,70,2,423.25,2,2,4,8,Loyal Customers
14165,275,1,5.9,1,1,1,3,At Risk
14167,39,4,52.45,3,3,3,9,Loyal Customers
14171,98,1,8.5,2,1,1,4,At Risk
14173,10,4,51.629999999999995,4,3,3,10,Champions
14174,33,1,5.78,3,1,1,5,Potential Customers
14175,51,7,18.399999999999995,2,4,2,8,Loyal Customers
14176,297,5,93.10000000000002,1,3,3,7,Loyal Customers
14177,84,5,169.60000000000002,2,3,4,9,Loyal Customers
14178,8,7,47.52,4,4,3,11,Champions
14179,40,2,3.9000000000000004,3,2,1,6,Potential Customers
14180,10,31,582.6700000000001,4,4,4,12,Champions
14184,66,1,33.0,2,1,2,5,Potential Customers
14185,331,1,12.75,1,1,1,3,At Risk
14188,8,10,67.94999999999999,4,4,3,11,Champions
14189,2,24,236.05,4,4,4,12,Champions
14191,1,14,288.96,4,4,4,12,Champions
14193,67,2,37.8,2,2,2,6,Potential Customers
14194,4,32,447.76,4,4,4,12,Champions
14195,201,3,287.3,1,3,4,8,Loyal Customers
14196,106,1,30.0,2,1,2,5,Potential Customers
14198,4,7,45.95,4,4,3,11,Champions
14199,218,1,175.2,1,1,4,6,Potential Customers
14201,60,9,146.45999999999998,2,4,4,10,Champions
14204,2,1,2.08,4,1,1,6,Potential Customers
14205,10,4,16.380000000000003,4,3,2,9,Loyal Customers
14206,239,2,3.5,1,2,1,4,At Risk
14208,94,1,10.5,2,1,1,4,At Risk
14209,10,7,114.4,4,4,4,12,Champions
14210,91,7,103.55,2,4,3,9,Loyal Customers
14211,53,13,207.82999999999998,2,4,4,10,Champions
14212,89,1,237.60000000000002,2,1,4,7,Loyal Customers
14213,371,1,-367.20000000000005,1,1,1,3,Returned/Churned
14214,30,7,76.0,3,4,3,10,Champions
14215,11,7,103.2,4,4,3,11,Champions
14216,3,4,200.06,4,3,4,11,Champions
14217,1,24,413.61,4,4,4,12,Champions
14218,42,1,4.5600000000000005,3,1,1,5,Potential Customers
14219,4,1,16.5,4,1,2,7,Loyal Customers
14220,247,2,62.050000000000004,1,2,3,6,Potential Customers
14221,42,10,191.85,3,4,4,11,Champions
14222,177,1,10.5,1,1,1,3,At Risk
14223,92,4,30.799999999999997,2,3,2,7,Loyal Customers
14224,110,4,54.25,2,3,3,8,Loyal Customers
14226,28,7,160.05,3,4,4,11,Champions
14227,26,15,188.04,3,4,4,11,Champions
14229,51,5,171.05,2,3,4,9,Loyal Customers
14231,179,5,22.549999999999997,1,3,2,6,Potential Customers
14232,31,8,93.6,3,4,3,10,Champions
14233,43,5,349.19,3,3,4,10,Champions
14234,22,4,46.98,3,3,3,9,Loyal Customers
14235,10,6,299.0,4,4,4,12,Champions
14236,80,2,171.6,2,2,4,8,Loyal Customers
14237,373,1,14.850000000000001,1,1,1,3,At Risk
14238,326,1,22.5,1,1,2,4,At Risk
14239,43,13,191.02,3,4,4,11,Champions
14240,30,2,29.759999999999998,3,2,2,7,Loyal Customers
14241,183,1,17.700000000000003,1,1,2,4,At Risk
14242,234,2,40.5,1,2,3,6,Potential Customers
14243,8,14,217.73000000000002,4,4,4,12,Champions
14245,176,5,15.82,1,3,2,6,Potential Customers
14246,110,3,62.25000000000001,2,3,3,8,Loyal Customers
14247,278,1,9.95,1,1,1,3,At Risk
14248,318,1,15.0,1,1,1,3,At Risk
14250,7,3,54.150000000000006,4,3,3,10,Champions
14251,1,5,358.20000000000005,4,3,4,11,Champions
14256,254,3,-10.280000000000001,1,3,1,5,Returned/Churned
14257,51,6,145.32000000000002,2,4,4,10,Champions
14258,9,10,1052.8000000000002,4,4,4,12,Champions
14259,141,1,33.0,2,1,2,5,Potential Customers
14261,50,2,36.3,3,2,2,7,Loyal Customers
14262,8,8,303.12,4,4,4,12,Champions
14264,154,3,44.45,1,3,3,7,Loyal Customers
14265,109,2,45.3,2,2,3,7,Loyal Customers
14267,150,7,-2.2199999999999918,1,4,1,6,Returned/Churned
14270,331,1,23.8,1,1,2,4,At Risk
14271,225,1,7.800000000000001,1,1,1,3,At Risk
14272,73,2,35.5,2,2,2,6,Potential Customers
14273,51,4,83.2,2,3,3,8,Loyal Customers
14276,88,5,56.55,2,3,3,8,Loyal Customers
14277,15,4,-31.19999999999999,4,3,1,8,Returned/Churned
14280,196,1,14.850000000000001,1,1,1,3,At Risk
14282,3,15,399.34000000000003,4,4,4,12,Champions
14284,30,3,29.0,3,3,2,8,Loyal Customers
14285,21,4,222.20000000000005,3,3,4,10,Champions
14286,23,5,27.96,3,3,2,8,Loyal Customers
14287,8,4,54.78,4,3,3,10,Champions
14288,212,2,22.650000000000006,1,2,2,5,Potential Customers
14289,8,6,133.32,4,4,4,12,Champions
14290,11,6,67.83,4,4,3,11,Champions
14291,1,12,202.88,4,4,4,12,Champions
14292,7,14,364.07,4,4,4,12,Champions
14293,3,4,108.15,4,3,3,10,Champions
14295,40,2,12.0,3,2,1,6,Potential Customers
14297,17,6,87.97999999999999,3,4,3,10,Champions
14298,3,45,2372.89,4,4,4,12,Champions
14299,8,18,-423.21999999999997,4,4,1,9,Returned/Churned
14300,18,1,16.5,3,1,2,6,Potential Customers
14301,107,2,58.75,2,2,3,7,Loyal Customers
14304,222,2,15.0,1,2,1,4,At Risk
14305,71,5,11.549999999999999,2,3,1,6,Potential Customers
14306,51,3,236.03,2,3,4,9,Loyal Customers
14307,88,6,90.12,2,4,3,9,Loyal Customers
14309,8,10,225.5,4,4,4,12,Champions
14311,225,2,-5.1,1,2,1,4,Returned/Churned
14312,46,6,96.52,3,4,3,10,Champions
14314,106,1,4.8,2,1,1,4,At Risk
14315,21,7,134.82999999999998,3,4,4,11,Champions
14317,64,1,16.5,2,1,2,5,Potential Customers
14320,206,3,11.189999999999998,1,3,1,5,Potential Customers
14321,10,5,117.84,4,3,4,11,Champions
14323,114,4,13.749999999999996,2,3,1,6,Potential Customers
14326,234,2,43.0,1,2,3,6,Potential Customers
14327,163,1,39.599999999999994,1,1,3,5,Potential Customers
14329,8,14,102.6,4,4,3,11,Champions
14331,124,2,32.85,2,2,2,6,Potential Customers
14332,22,3,204.84000000000003,3,3,4,10,Champions
14333,64,2,42.5,2,2,3,7,Loyal Customers
14334,16,9,102.2,4,4,3,11,Champions
14335,16,2,11.4,4,2,1,7,Loyal Customers
14336,16,4,74.4,4,3,3,10,Champions
14338,158,4,16.700000000000003,1,3,2,6,Potential Customers
14339,234,4,7.749999999999998,1,3,1,5,Potential Customers
14340,218,1,27.0,1,1,2,4,At Risk
14341,45,9,126.15,3,4,4,11,Champions
14342,21,6,182.29999999999998,3,4,4,11,Champions
14344,127,8,125.70000000000002,2,4,4,10,Champions
14345,38,1,15.0,3,1,1,5,Potential Customers
14346,120,2,22.5,2,2,2,6,Potential Customers
14348,260,1,91.80000000000001,1,1,3,5,Potential Customers
14349,10,1,1.95,4,1,1,6,Potential Customers
14350,270,2,16.85,1,2,2,5,Potential Customers
14351,164,1,51.0,1,1,3,5,Potential Customers
14352,157,4,148.0,1,3,4,8,Loyal Customers
14353,215,1,3.9000000000000004,1,1,1,3,At Risk
14354,5,2,56.4,4,2,3,9,Loyal Customers
14355,365,1,17.700000000000003,1,1,2,4,At Risk
14356,60,4,32.3,2,3,2,7,Loyal Customers
14357,43,1,7.5,3,1,1,5,Potential Customers
14359,19,6,10.799999999999997,3,4,1,8,Loyal Customers
14360,31,4,71.1,3,3,3,9,Loyal Customers
14362,22,1,4.25,3,1,1,5,Potential Customers
14364,108,8,562.06,2,4,4,10,Champions
14367,8,19,499.8,4,4,4,12,Champions
14368,319,1,17.0,1,1,2,4,At Risk
14371,295,1,19.8,1,1,2,4,At Risk
14373,358,1,25.5,1,1,2,4,At Risk
14375,185,1,2.95,1,1,1,3,At Risk
14377,191,2,195.14999999999998,1,2,4,7,Loyal Customers
14379,44,2,35.85,3,2,2,7,Loyal Customers
14381,52,1,2.6,2,1,1,4,At Risk
14382,26,1,10.5,3,1,1,5,Potential Customers
14383,38,3,83.8,3,3,3,9,Loyal Customers
14385,9,3,51.15,4,3,3,10,Champions
14386,296,1,31.8,1,1,2,4,At Risk
14387,32,3,42.0,3,3,3,9,Loyal Customers
14388,8,10,112.37,4,4,4,12,Champions
14389,8,5,45.580000000000005,4,3,3,10,Champions
14390,10,13,97.99,4,4,3,11,Champions
14393,218,1,17.25,1,1,2,4,At Risk
14395,2,12,48.5,4,4,3,11,Champions
14396,65,2,10.100000000000001,2,2,1,5,Potential Customers
14397,0,23,683.8199999999999,4,4,4,12,Champions
14400,141,2,0.0,2,2,1,5,Returned/Churned
14401,4,14,340.52,4,4,4,12,Champions
14403,130,5,269.85,2,3,4,9,Loyal Customers
14404,33,7,100.42,3,4,3,10,Champions
14406,119,1,20.8,2,1,2,5,Potential Customers
14407,107,9,425.20000000000005,2,4,4,10,Champions
14408,10,7,180.8,4,4,4,12,Champions
14409,71,7,246.20000000000002,2,4,4,10,Champions
14410,15,15,111.33000000000001,4,4,4,12,Champions
14411,310,1,91.80000000000001,1,1,3,5,Potential Customers
14412,35,3,42.15,3,3,3,9,Loyal Customers
14413,362,1,0.95,1,1,1,3,At Risk
14414,91,8,70.38999999999999,2,4,3,9,Loyal Customers
14415,1,18,146.37,4,4,4,12,Champions
14416,22,2,39.5,3,2,2,7,Loyal Customers
14418,3,3,39.54,4,3,3,10,Champions
14419,10,6,29.5,4,4,2,10,Champions
14420,85,2,18.15,2,2,2,6,Potential Customers
14421,57,2,37.199999999999996,2,2,2,6,Potential Customers
14422,0,6,156.1,4,4,4,12,Champions
14423,218,1,163.2,1,1,4,6,Potential Customers
14424,17,1,322.08,3,1,4,8,Loyal Customers
14426,18,16,190.32,3,4,4,11,Champions
14427,50,2,46.64,3,2,3,8,Loyal Customers
14428,7,7,107.99000000000001,4,4,3,11,Champions
14431,298,2,24.699999999999996,1,2,2,5,Potential Customers
14432,9,6,71.52,4,4,3,11,Champions
14434,21,6,649.2,3,4,4,11,Champions
14436,98,1,12.5,2,1,1,4,At Risk
14437,143,2,-91.4,2,2,1,5,Returned/Churned
14438,306,1,7.5,1,1,1,3,At Risk
14439,319,1,61.199999999999996,1,1,3,5,Potential Customers
14440,8,5,152.12,4,3,4,11,Champions
14441,0,10,-52.54999999999999,4,4,1,9,Returned/Churned
14442,1,5,10.500000000000004,4,3,1,8,Loyal Customers
14443,53,7,35.86,2,4,2,8,Loyal Customers
14446,0,4,30.2,4,3,2,9,Loyal Customers
14447,18,5,94.5,3,3,3,9,Loyal Customers
14448,9,2,38.7,4,2,2,8,Loyal Customers
14449,18,4,11.91,3,3,1,7,Loyal Customers
14450,180,3,27.400000000000002,1,3,2,6,Potential Customers
14451,60,2,18.299999999999997,2,2,2,6,Potential Customers
14452,10,2,8.25,4,2,1,7,Loyal Customers
14453,190,1,5.75,1,1,1,3,At Risk
14456,5,14,39.410000000000004,4,4,2,10,Champions
14457,310,1,45.0,1,1,3,5,Potential Customers
14459,155,1,76.5,1,1,3,5,Potential Customers
14460,110,4,58.199999999999996,2,3,3,8,Loyal Customers
14461,148,3,49.5,1,3,3,7,Loyal Customers
14462,63,15,101.84,2,4,3,9,Loyal Customers
14463,98,3,229.79999999999998,2,3,4,9,Loyal Customers
14465,246,3,27.49,1,3,2,6,Potential Customers
14466,29,7,267.6,3,4,4,11,Champions
14467,17,4,24.25,3,3,2,8,Loyal Customers
14470,11,2,18.15,4,2,2,8,Loyal Customers
14472,103,8,57.410000000000004,2,4,3,9,Loyal Customers
14473,74,2,123.16,2,2,4,8,Loyal Customers
14474,43,2,1.75,3,2,1,6,Potential Customers
14475,71,6,-72.07000000000001,2,4,1,7,Returned/Churned
14476,257,1,5.9,1,1,1,3,At Risk
14477,19,5,562.81,3,3,4,10,Champions
14479,253,2,32.45,1,2,2,5,Potential Customers
14480,11,1,20.28,4,1,2,7,Loyal Customers
14481,164,2,35.4,1,2,2,5,Potential Customers
14482,18,6,55.879999999999995,3,4,3,10,Champions
14483,149,2,0.9500000000000011,1,2,1,4,At Risk
14484,50,1,20.4,3,1,2,6,Potential Customers
14485,38,1,1.65,3,1,1,5,Potential Customers
14487,26,7,76.15,3,4,3,10,Champions
14488,51,2,21.5,2,2,2,6,Potential Customers
14489,207,1,29.88,1,1,2,4,At Risk
14491,175,2,66.6,1,2,3,6,Potential Customers
14493,7,7,136.14,4,4,4,12,Champions
14494,25,1,17.4,3,1,2,6,Potential Customers
14495,50,2,41.6,3,2,3,8,Loyal Customers
14496,311,2,37.5,1,2,2,5,Potential Customers
14497,301,2,5.65,1,2,1,4,At Risk
14498,42,5,52.94,3,3,3,9,Loyal Customers
14499,26,3,20.099999999999998,3,3,2,8,Loyal Customers
14500,88,3,84.75,2,3,3,8,Loyal Customers
14501,64,3,9.940000000000005,2,3,1,6,Potential Customers
14502,19,14,137.07,3,4,4,11,Champions
14503,3,6,291.0,4,4,4,12,Champions
14504,47,4,27.67,3,3,2,8,Loyal Customers
14505,17,11,-4.399999999999997,3,4,1,8,Returned/Churned
14506,17,5,81.75,3,3,3,9,Loyal Customers
14507,23,7,337.65000000000003,3,4,4,11,Champions
14508,22,2,10.74,3,2,1,6,Potential Customers
14511,11,6,78.7,4,4,3,11,Champions
14512,187,2,24.15,1,2,2,5,Potential Customers
14513,100,4,194.24,2,3,4,9,Loyal Customers
14514,61,3,78.75,2,3,3,8,Loyal Customers
14515,17,6,85.03,3,4,3,10,Champions
14517,33,2,63.0,3,2,3,8,Loyal Customers
14518,64,1,0.95,2,1,1,4,At Risk
14520,1,2,175.2,4,2,4,10,Champions
14522,24,4,288.84,3,3,4,10,Champions
14523,108,1,12.5,2,1,1,4,At Risk
14524,31,9,164.26,3,4,4,11,Champions
14525,8,13,53.17999999999999,4,4,3,11,Champions
14527,2,86,-76.92000000000002,4,4,1,9,Returned/Churned
14528,37,1,4.35,3,1,1,5,Potential Customers
14529,60,3,3.37,2,3,1,6,Potential Customers
14530,25,6,154.25,3,4,4,11,Champions
14532,236,4,62.6,1,3,3,7,Loyal Customers
14533,24,9,103.01999999999998,3,4,3,10,Champions
14534,2,25,39.42999999999999,4,4,2,10,Champions
14535,59,4,36.75,2,3,2,7,Loyal Customers
14536,259,1,0.85,1,1,1,3,At Risk
14537,57,1,49.800000000000004,2,1,3,6,Potential Customers
14538,64,2,50.7,2,2,3,7,Loyal Customers
14539,15,2,34.8,4,2,2,8,Loyal Customers
14540,9,3,38.95,4,3,2,9,Loyal Customers
14541,58,8,153.81,2,4,4,10,Champions
14542,185,1,17.0,1,1,2,4,At Risk
14543,3,21,849.75,4,4,4,12,Champions
14544,24,2,35.199999999999996,3,2,2,7,Loyal Customers
14546,4,9,37.540000000000006,4,4,2,10,Champions
14547,3,9,69.53999999999999,4,4,3,11,Champions
14548,150,2,326.4,1,2,4,7,Loyal Customers
14549,311,1,8.25,1,1,1,3,At Risk
14550,10,2,20.78,4,2,2,8,Loyal Customers
14551,18,2,27.64,3,2,2,7,Loyal Customers
14552,151,1,3.38,1,1,1,3,At Risk
14553,19,5,38.65,3,3,2,8,Loyal Customers
14554,10,4,111.92,4,3,4,11,Champions
14555,57,2,38.8,2,2,2,6,Potential Customers
14557,64,2,-30.24000000000001,2,2,1,5,Returned/Churned
14560,7,24,825.1899999999999,4,4,4,12,Champions
14561,75,3,34.2,2,3,2,7,Loyal Customers
14562,3,22,240.57,4,4,4,12,Champions
14565,95,6,41.91,2,4,3,9,Loyal Customers
14566,110,1,358.0,2,1,4,7,Loyal Customers
14567,35,3,88.9,3,3,3,9,Loyal Customers
14569,1,1,1.95,4,1,1,6,Potential Customers
14570,280,2,6.75,1,2,1,4,At Risk
14572,3,10,68.85000000000001,4,4,3,11,Champions
14573,179,13,16.650000000000002,1,4,2,7,Loyal Customers
14576,372,1,35.400000000000006,1,1,2,4,At Risk
14577,12,4,31.7,4,3,2,9,Loyal Customers
14578,3,1,28.080000000000002,4,1,2,7,Loyal Customers
14581,16,1,15.600000000000001,4,1,2,7,Loyal Customers
14582,40,1,19.9,3,1,2,6,Potential Customers
14583,5,5,18.77,4,3,2,9,Loyal Customers
14584,169,5,18.5,1,3,2,6,Potential Customers
14585,50,1,1.66,3,1,1,5,Potential Customers
14586,227,3,-4.920000000000001,1,3,1,5,Returned/Churned
14587,18,10,66.05000000000001,3,4,3,10,Champions
14589,371,1,15.9,1,1,2,4,At Risk
14591,15,4,124.26,4,3,4,11,Champions
14592,35,3,7.54,3,3,1,7,Loyal Customers
14593,21,3,9.29,3,3,1,7,Loyal Customers
14594,7,2,4.6,4,2,1,7,Loyal Customers
14595,19,6,89.94,3,4,3,10,Champions
14597,11,2,37.71,4,2,2,8,Loyal Customers
14598,44,1,1.7,3,1,1,5,Potential Customers
14600,305,1,15.0,1,1,1,3,At Risk
14601,10,1,90.0,4,1,3,8,Loyal Customers
14603,274,1,150.0,1,1,4,6,Potential Customers
14606,1,128,892.97,4,4,4,12,Champions
14607,15,17,5095.18,4,4,4,12,Champions
14608,4,4,532.0,4,3,4,11,Champions
14609,72,4,601.56,2,3,4,9,Loyal Customers
14616,242,3,406.08000000000004,1,3,4,8,Loyal Customers
14618,9,4,94.95,4,3,3,10,Champions
14619,239,2,9.95,1,2,1,4,At Risk
14620,204,3,15.9,1,3,2,6,Potential Customers
14621,1,6,142.95,4,4,4,12,Champions
14622,184,1,20.8,1,1,2,4,At Risk
14623,32,6,12.41,3,4,1,8,Loyal Customers
14624,57,2,35.1,2,2,2,6,Potential Customers
14625,185,5,-16.9,1,3,1,5,Returned/Churned
14626,8,7,46.68,4,4,3,11,Champions
14627,311,1,-3.75,1,1,1,3,Returned/Churned
14628,91,2,54.6,2,2,3,7,Loyal Customers
14629,4,3,-0.35000000000000053,4,3,1,8,Returned/Churned
14631,50,3,114.30000000000001,3,3,4,10,Champions
14632,262,1,15.9,1,1,2,4,At Risk
14633,266,1,15.8,1,1,2,4,At Risk
14636,36,2,62.46,3,2,3,8,Loyal Customers
14638,50,1,57.800000000000004,3,1,3,7,Loyal Customers
14639,52,8,97.19,2,4,3,9,Loyal Customers
14640,15,8,162.36,4,4,4,12,Champions
14641,21,1,39.599999999999994,3,1,3,7,Loyal Customers
14642,58,1,19.8,2,1,2,5,Potential Customers
14643,170,3,22.36,1,3,2,6,Potential Customers
14644,9,4,63.54000000000002,4,3,3,10,Champions
14645,156,2,39.099999999999994,1,2,2,5,Potential Customers
14646,1,77,18688.06,4,4,4,12,Champions
14647,201,1,9.9,1,1,1,3,At Risk
14649,4,4,52.75,4,3,3,10,Champions
14651,67,2,9.39,2,2,1,5,Potential Customers
14652,77,1,4.25,2,1,1,4,At Risk
14653,1,7,82.92,4,4,3,11,Champions
14655,3,5,79.47,4,3,3,10,Champions
14656,169,2,22.7,1,2,2,5,Potential Customers
14657,17,5,23.57,3,3,2,8,Loyal Customers
14658,5,2,3.74,4,2,1,7,Loyal Customers
14659,8,12,90.73,4,4,3,11,Champions
14660,86,2,8.64,2,2,1,5,Potential Customers
14661,26,1,0.85,3,1,1,5,Potential Customers
14662,28,4,12.65,3,3,1,7,Loyal Customers
14664,19,2,22.4,3,2,2,7,Loyal Customers
14665,60,7,182.55,2,4,4,10,Champions
14666,24,1,6.6,3,1,1,5,Potential Customers
14667,10,27,408.27,4,4,4,12,Champions
14669,241,3,27.35,1,3,2,6,Potential Customers
14670,280,2,13.9,1,2,1,4,At Risk
14672,234,2,17.55,1,2,2,5,Potential Customers
14673,3,5,156.45,4,3,4,11,Champions
14675,16,1,1.65,4,1,1,6,Potential Customers
14676,31,8,487.6,3,4,4,11,Champions
14679,371,1,-2.55,1,1,1,3,Returned/Churned
14680,25,23,1889.3600000000001,3,4,4,11,Champions
14681,71,3,120.0,2,3,4,9,Loyal Customers
14682,187,2,52.0,1,2,3,6,Potential Customers
14684,25,5,11.48,3,3,1,7,Loyal Customers
14687,106,1,10.2,2,1,1,4,At Risk
14688,7,27,735.02,4,4,4,12,Champions
14689,208,1,7.95,1,1,1,3,At Risk
14690,44,3,10.649999999999999,3,3,1,7,Loyal Customers
14691,30,5,180.89999999999998,3,3,4,10,Champions
14692,137,5,27.550000000000004,2,3,2,7,Loyal Customers
14693,264,1,4.25,1,1,1,3,At Risk
14696,4,9,102.52000000000001,4,4,3,11,Champions
14697,218,2,22.63,1,2,2,5,Potential Customers
14698,1,5,35.4,4,3,2,9,Loyal Customers
14699,214,1,12.600000000000001,1,1,1,3,At Risk
14700,32,3,22.45,3,3,2,8,Loyal Customers
14701,10,12,166.64000000000001,4,4,4,12,Champions
14702,1,18,122.62,4,4,4,12,Champions
14703,14,1,16.5,4,1,2,7,Loyal Customers
14704,11,9,72.95,4,4,3,11,Champions
14705,198,1,179.0,1,1,4,6,Potential Customers
14708,2,4,132.0,4,3,4,11,Champions
14709,15,14,255.2,4,4,4,12,Champions
14710,14,4,44.559999999999995,4,3,3,10,Champions
14711,10,12,374.25,4,4,4,12,Champions
14712,29,3,164.65,3,3,4,10,Champions
14713,9,12,227.22,4,4,4,12,Champions
14714,24,1,9.899999999999999,3,1,1,5,Potential Customers
14715,24,4,104.8,3,3,3,9,Loyal Customers
14716,43,2,7.19,3,2,1,6,Potential Customers
14719,1,6,44.699999999999996,4,4,3,11,Champions
14720,5,3,45.75,4,3,3,10,Champions
14722,147,1,7.95,1,1,1,3,At Risk
14723,10,6,26.5,4,4,2,10,Champions
14725,24,1,12.5,3,1,1,5,Potential Customers
14727,274,1,50.849999999999994,1,1,3,5,Potential Customers
14729,373,1,6.75,1,1,1,3,At Risk
14730,1,8,41.95,4,4,3,11,Champions
14731,47,3,46.2,3,3,3,9,Loyal Customers
14732,8,10,134.69,4,4,4,12,Champions
14733,9,15,466.89000000000004,4,4,4,12,Champions
14735,3,34,1268.76,4,4,4,12,Champions
14737,3,3,318.0,4,3,4,11,Champions
14738,39,9,143.39,3,4,4,11,Champions
14739,2,8,459.72,4,4,4,12,Champions
14740,191,4,38.989999999999995,1,3,2,6,Potential Customers
14741,11,6,229.3,4,4,4,12,Champions
14744,16,9,115.93,4,4,4,12,Champions
14745,112,6,92.50000000000001,2,4,3,9,Loyal Customers
14747,247,2,0.0,1,2,1,4,Returned/Churned
14748,29,6,65.17999999999999,3,4,3,10,Champions
14752,43,1,208.79999999999998,3,1,4,8,Loyal Customers
14753,87,1,17.85,2,1,2,5,Potential Customers
14754,44,2,31.5,3,2,2,7,Loyal Customers
14755,9,12,275.44,4,4,4,12,Champions
14756,15,1,20.8,4,1,2,7,Loyal Customers
14757,75,1,34.5,2,1,2,5,Potential Customers
14758,144,4,83.32,1,3,3,7,Loyal Customers
14759,4,3,54.25,4,3,3,10,Champions
14760,294,2,-7.5000000000000036,1,2,1,4,Returned/Churned
14761,58,2,56.699999999999996,2,2,3,7,Loyal Customers
14762,263,1,15.0,1,1,1,3,At Risk
14764,43,2,39.45,3,2,2,7,Loyal Customers
14765,29,3,36.95,3,3,2,8,Loyal Customers
14766,8,8,72.68,4,4,3,11,Champions
14768,17,3,41.70000000000001,3,3,3,9,Loyal Customers
14769,2,10,113.00999999999999,4,4,4,12,Champions
14770,232,2,25.5,1,2,2,5,Potential Customers
14772,112,1,17.4,2,1,2,5,Potential Customers
14775,58,3,59.99999999999999,2,3,3,8,Loyal Customers
14776,51,13,200.7,2,4,4,10,Champions
14777,4,2,-14.5,4,2,1,7,Returned/Churned
14778,127,2,60.0,2,2,3,7,Loyal Customers
14779,280,3,54.95,1,3,3,7,Loyal Customers
14780,54,2,35.02,2,2,2,6,Potential Customers
14782,319,1,90.0,1,1,3,5,Potential Customers
14784,26,2,80.51,3,2,3,8,Loyal Customers
14785,10,2,67.92,4,2,3,9,Loyal Customers
14788,7,2,37.5,4,2,2,8,Loyal Customers
14789,28,1,28.44,3,1,2,6,Potential Customers
14790,16,4,121.42,4,3,4,11,Champions
14792,63,2,0.0,2,2,1,5,Returned/Churned
14793,4,2,0.14999999999999858,4,2,1,7,Loyal Customers
14794,2,9,100.65,4,4,3,11,Champions
14795,166,1,31.8,1,1,2,4,At Risk
14796,1,27,54.57000000000001,4,4,3,11,Champions
14798,52,3,40.2,2,3,3,8,Loyal Customers
14799,51,1,5.76,2,1,1,4,At Risk
14800,47,16,-10.059999999999999,3,4,1,8,Returned/Churned
14801,61,1,0.72,2,1,1,4,At Risk
14803,162,3,181.54999999999998,1,3,4,8,Loyal Customers
14804,8,1,53.1,4,1,3,8,Loyal Customers
14805,15,4,102.69999999999999,4,3,3,10,Champions
14806,75,1,10.5,2,1,1,4,At Risk
14808,39,15,-175.44,3,4,1,8,Returned/Churned
14810,40,11,143.1,3,4,4,11,Champions
14813,369,2,8.5,1,2,1,4,At Risk
14815,36,2,42.36,3,2,3,8,Loyal Customers
14816,197,1,9.95,1,1,1,3,At Risk
14817,200,2,21.25,1,2,2,5,Potential Customers
14818,73,3,17.5,2,3,2,7,Loyal Customers
14819,64,2,37.77,2,2,2,6,Potential Customers
14820,21,4,81.7,3,3,3,9,Loyal Customers
14821,366,1,25.200000000000003,1,1,2,4,At Risk
14823,180,3,19.45,1,3,2,6,Potential Customers
14824,10,4,267.2,4,3,4,11,Champions
14825,3,12,272.97,4,4,4,12,Champions
14828,196,3,496.94000000000005,1,3,4,8,Loyal Customers
14829,29,6,54.6,3,4,3,10,Champions
14830,53,1,2.08,2,1,1,4,At Risk
14834,17,8,327.13,3,4,4,11,Champions
14836,10,3,41.4,4,3,3,10,Champions
14837,89,5,55.209999999999994,2,3,3,8,Loyal Customers
14840,267,1,15.0,1,1,1,3,At Risk
14841,53,6,207.93,2,4,4,10,Champions
14842,35,8,-231.9,3,4,1,8,Returned/Churned
14844,63,4,99.2,2,3,3,8,Loyal Customers
14847,148,1,25.0,1,1,2,4,At Risk
14849,21,28,454.05,3,4,4,11,Champions
14850,311,2,-45.5,1,2,1,4,Returned/Churned
14851,23,2,73.2,3,2,3,8,Loyal Customers
14852,58,6,122.0,2,4,4,10,Champions
14853,8,3,182.25,4,3,4,11,Champions
14854,78,8,196.55,2,4,4,10,Champions
14855,119,2,50.39999999999999,2,2,3,7,Loyal Customers
14856,36,3,46.5,3,3,3,9,Loyal Customers
14857,59,3,37.83,2,3,2,7,Loyal Customers
14859,12,5,67.54,4,3,3,10,Champions
14860,8,2,11.82,4,2,1,7,Loyal Customers
14861,52,1,39.6,2,1,3,6,Potential Customers
14862,25,2,38.68,3,2,2,7,Loyal Customers
14863,29,1,34.68,3,1,2,6,Potential Customers
14865,7,2,33.0,4,2,2,8,Loyal Customers
14866,10,13,1254.0,4,4,4,12,Champions
14867,185,4,30.97,1,3,2,6,Potential Customers
14868,3,9,148.45,4,4,4,12,Champions
14869,3,3,28.65,4,3,2,9,Loyal Customers
14870,261,1,14.850000000000001,1,1,1,3,At Risk
14871,3,4,41.84,4,3,3,10,Champions
14873,210,1,25.5,1,1,2,4,At Risk
14875,9,5,60.50000000000001,4,3,3,10,Champions
14878,12,9,263.75,4,4,4,12,Champions
14880,77,3,45.3,2,3,3,8,Loyal Customers
14881,19,1,15.0,3,1,1,5,Potential Customers
14882,26,2,128.4,3,2,4,9,Loyal Customers
14883,18,7,53.53,3,4,3,10,Champions
14885,131,1,20.4,2,1,2,5,Potential Customers
14886,252,1,39.8,1,1,3,5,Potential Customers
14887,79,1,72.0,2,1,3,6,Potential Customers
14888,207,1,16.5,1,1,2,4,At Risk
14889,336,1,10.2,1,1,1,3,At Risk
14890,253,1,10.2,1,1,1,3,At Risk
14891,148,2,43.5,1,2,3,6,Potential Customers
14893,9,2,24.96,4,2,2,8,Loyal Customers
14894,85,1,40.8,2,1,3,6,Potential Customers
14895,7,24,596.84,4,4,4,12,Champions
14896,204,2,28.650000000000002,1,2,2,5,Potential Customers
14897,7,4,79.56,4,3,3,10,Champions
14898,23,8,123.85999999999999,3,4,4,11,Champions
14901,11,10,140.91,4,4,4,12,Champions
14902,21,2,11.5,3,2,1,6,Potential Customers
14903,21,10,9.749999999999998,3,4,1,8,Loyal Customers
14904,2,2,37.44,4,2,2,8,Loyal Customers
14905,154,3,104.94999999999999,1,3,3,7,Loyal Customers
14907,3,10,194.47,4,4,4,12,Champions
14908,74,1,9.9,2,1,1,4,At Risk
14910,2,7,23.150000000000006,4,4,2,10,Champions
14911,1,248,6614.09,4,4,4,12,Champions
14912,16,3,20.470000000000002,4,3,2,9,Loyal Customers
14913,35,4,34.019999999999996,3,3,2,8,Loyal Customers
14915,85,3,8.829999999999998,2,3,1,6,Potential Customers
14916,70,5,28.229999999999997,2,3,2,7,Loyal Customers
14918,115,2,85.80000000000001,2,2,3,7,Loyal Customers
14920,212,2,34.2,1,2,2,5,Potential Customers
14921,30,2,55.080000000000005,3,2,3,8,Loyal Customers
14923,50,1,19.8,3,1,2,6,Potential Customers
14924,245,1,47.400000000000006,1,1,3,5,Potential Customers
14929,32,1,17.4,3,1,2,6,Potential Customers
14930,108,3,72.39,2,3,3,8,Loyal Customers
14931,4,6,62.93999999999998,4,4,3,11,Champions
14932,365,1,15.9,1,1,2,4,At Risk
14934,72,3,53.699999999999996,2,3,3,8,Loyal Customers
14935,297,1,162.72,1,1,4,6,Potential Customers
14936,9,9,233.85,4,4,4,12,Champions
14937,56,4,288.55,2,3,4,9,Loyal Customers
14944,29,14,434.65000000000003,3,4,4,11,Champions
14946,14,1,33.2,4,1,2,7,Loyal Customers
14947,72,2,70.32,2,2,3,7,Loyal Customers
14948,23,7,83.52000000000001,3,4,3,10,Champions
14950,8,2,7.050000000000001,4,2,1,7,Loyal Customers
14951,79,1,1.92,2,1,1,4,At Risk
14952,46,15,824.33,3,4,4,11,Champions
14953,25,1,3.3,3,1,1,5,Potential Customers
14954,12,1,4.25,4,1,1,6,Potential Customers
14957,253,1,5.0,1,1,1,3,At Risk
14958,147,3,47.9,1,3,3,7,Loyal Customers
14959,59,5,51.25,2,3,3,8,Loyal Customers
14960,8,2,84.0,4,2,3,9,Loyal Customers
14961,10,12,274.15000000000003,4,4,4,12,Champions
14962,270,1,14.850000000000001,1,1,1,3,At Risk
14963,9,5,41.300000000000004,4,3,3,10,Champions
14964,247,1,12.75,1,1,1,3,At Risk
14965,96,2,77.08,2,2,3,7,Loyal Customers
14966,14,1,2.5,4,1,1,6,Potential Customers
14967,49,1,15.0,3,1,1,5,Potential Customers
14968,30,1,1.66,3,1,1,5,Potential Customers
14970,68,4,175.58,2,3,4,9,Loyal Customers
14971,35,3,35.849999999999994,3,3,2,8,Loyal Customers
14972,128,1,12.75,2,1,1,4,At Risk
14973,107,3,74.7,2,3,3,8,Loyal Customers
14974,37,1,4.95,3,1,1,5,Potential Customers
14975,57,1,11.7,2,1,1,4,At Risk
14976,57,8,42.0,2,4,3,9,Loyal Customers
14978,72,5,75.15,2,3,3,8,Loyal Customers
14981,246,1,16.5,1,1,2,4,At Risk
14984,19,2,7.53,3,2,1,6,Potential Customers
14985,198,2,8.85,1,2,1,4,At Risk
14987,15,2,163.2,4,2,4,10,Champions
14988,211,1,1.66,1,1,1,3,At Risk
14995,38,2,12.45,3,2,1,6,Potential Customers
14997,46,4,37.86,3,3,2,8,Loyal Customers
14998,170,2,7.85,1,2,1,4,At Risk
15000,47,1,13.9,3,1,1,5,Potential Customers
15002,115,4,73.5,2,3,3,8,Loyal Customers
15004,147,1,3.3,1,1,1,3,At Risk
15005,15,35,131.83,4,4,4,12,Champions
15006,51,1,5.9,2,1,1,4,At Risk
15007,159,1,15.0,1,1,1,3,At Risk
15009,12,3,66.02,4,3,3,10,Champions
15010,35,1,22.5,3,1,2,6,Potential Customers
15012,53,2,6.7,2,2,1,5,Potential Customers
15014,43,2,39.45,3,2,2,7,Loyal Customers
15016,172,1,7.95,1,1,1,3,At Risk
15017,33,1,3.75,3,1,1,5,Potential Customers
15018,38,4,27.5,3,3,2,8,Loyal Customers
15019,266,1,0.85,1,1,1,3,At Risk
15021,8,13,26.17,4,4,2,10,Champions
15022,11,4,59.95,4,3,3,10,Champions
15023,3,12,86.86,4,4,3,11,Champions
15024,9,10,159.85,4,4,4,12,Champions
15025,33,1,5.95,3,1,1,5,Potential Customers
15026,80,3,22.2,2,3,2,7,Loyal Customers
15027,30,6,184.70000000000002,3,4,4,11,Champions
15028,8,4,58.45,4,3,3,10,Champions
15030,71,2,125.4,2,2,4,8,Loyal Customers
15031,4,4,7.4799999999999995,4,3,1,8,Loyal Customers
15032,256,5,-124.65,1,3,1,5,Returned/Churned
15033,4,11,71.34,4,4,3,11,Champions
15034,15,11,129.25,4,4,4,12,Champions
15035,89,1,3.75,2,1,1,4,At Risk
15036,72,3,28.270000000000003,2,3,2,7,Loyal Customers
15038,43,7,19.490000000000002,3,4,2,9,Loyal Customers
15039,9,52,1158.22,4,4,4,12,Champions
15041,170,1,4.15,1,1,1,3,At Risk
15042,199,1,76.5,1,1,3,5,Potential Customers
15043,31,1,179.0,3,1,4,8,Loyal Customers
15044,19,22,203.18,3,4,4,11,Champions
15045,151,3,-6.719999999999989,1,3,1,5,Returned/Churned
15046,9,16,279.67,4,4,4,12,Champions
15047,269,1,12.600000000000001,1,1,1,3,At Risk
15048,65,5,16.450000000000003,2,3,2,7,Loyal Customers
15049,273,1,1.7,1,1,1,3,At Risk
15050,25,5,63.940000000000005,3,3,3,9,Loyal Customers
15051,23,3,12.71,3,3,1,7,Loyal Customers
15052,319,1,5.1,1,1,1,3,At Risk
15053,4,3,30.9,4,3,2,9,Loyal Customers
15054,12,2,18.39,4,2,2,8,Loyal Customers
15057,275,2,329.09999999999997,1,2,4,7,Loyal Customers
15058,25,11,136.6,3,4,4,11,Champions
15059,40,11,68.87,3,4,3,10,Champions
15060,8,4,22.28,4,3,2,9,Loyal Customers
15061,3,55,5900.76,4,4,4,12,Champions
15062,71,4,68.5,2,3,3,8,Loyal Customers
15063,213,1,30.599999999999998,1,1,2,4,At Risk
15065,37,6,58.0,3,4,3,10,Champions
15066,31,2,14.4,3,2,1,6,Potential Customers
15067,78,3,72.9,2,3,3,8,Loyal Customers
15068,46,2,18.5,3,2,2,7,Loyal Customers
15069,179,1,12.75,1,1,1,3,At Risk
15070,372,1,106.2,1,1,3,5,Potential Customers
15071,93,2,155.8,2,2,4,8,Loyal Customers
15073,9,4,79.67999999999999,4,3,3,10,Champions
15074,105,1,34.68,2,1,2,5,Potential Customers
15075,77,1,33.2,2,1,2,5,Potential Customers
15076,172,1,21.9,1,1,2,4,At Risk
15078,7,38,613.74,4,4,4,12,Champions
15079,212,5,184.55,1,3,4,8,Loyal Customers
15081,22,6,75.55,3,4,3,10,Champions
15083,256,1,34.8,1,1,2,4,At Risk
15087,281,1,24.96,1,1,2,4,At Risk
15088,21,3,46.2,3,3,3,9,Loyal Customers
15089,10,6,111.11000000000001,4,4,4,12,Champions
15090,308,1,16.5,1,1,2,4,At Risk
15091,53,2,30.25,2,2,2,6,Potential Customers
15092,215,2,54.15,1,2,3,6,Potential Customers
15093,18,9,544.5799999999999,3,4,4,11,Champions
15095,103,5,82.25,2,3,3,8,Loyal Customers
15096,42,1,17.85,3,1,2,6,Potential Customers
15097,4,1,5.1,4,1,1,6,Potential Customers
15098,182,5,649.5,1,3,4,8,Loyal Customers
15099,84,1,14.75,2,1,1,4,At Risk
15100,330,6,635.1,1,4,4,9,Loyal Customers
15101,8,3,63.78,4,3,3,10,Champions
15103,31,2,40.739999999999995,3,2,3,8,Loyal Customers
15104,166,3,39.45,1,3,2,6,Potential Customers
15105,18,7,164.76,3,4,4,11,Champions
15106,17,7,68.10000000000001,3,4,3,10,Champions
15107,311,8,47.949999999999996,1,4,3,8,Loyal Customers
15108,141,5,81.75,2,3,3,8,Loyal Customers
15109,240,2,2.25,1,2,1,4,At Risk
15110,23,7,90.05000000000001,3,4,3,10,Champions
15111,29,3,89.80000000000001,3,3,3,9,Loyal Customers
15113,9,4,154.32999999999996,4,3,4,11,Champions
15114,30,10,185.72,3,4,4,11,Champions
15115,18,1,10.2,3,1,1,5,Potential Customers
15116,17,4,177.8,3,3,4,10,Champions
15117,14,6,212.3,4,4,4,12,Champions
15118,134,1,244.8,2,1,4,7,Loyal Customers
15119,245,1,33.9,1,1,2,4,At Risk
15120,129,2,24.6,2,2,2,6,Potential Customers
15121,50,2,34.650000000000006,3,2,2,7,Loyal Customers
15122,85,6,38.699999999999996,2,4,2,8,Loyal Customers
15123,7,2,30.9,4,2,2,8,Loyal Customers
15124,22,2,21.72,3,2,2,7,Loyal Customers
15125,25,23,1420.51,3,4,4,11,Champions
15127,65,1,24.75,2,1,2,5,Potential Customers
15128,60,8,52.94,2,4,3,9,Loyal Customers
15129,50,11,1046.4,3,4,4,11,Champions
15130,169,1,15.0,1,1,1,3,At Risk
15132,18,5,113.50000000000001,3,3,4,10,Champions
15133,127,3,96.56,2,3,3,8,Loyal Customers
15134,14,8,187.58,4,4,4,12,Champions
15135,233,2,7.6,1,2,1,4,At Risk
15136,2,5,68.58000000000001,4,3,3,10,Champions
15139,239,2,22.560000000000002,1,2,2,5,Potential Customers
15140,52,8,156.91,2,4,4,10,Champions
15142,46,1,15.0,3,1,1,5,Potential Customers
15143,225,1,19.799999999999997,1,1,2,4,At Risk
15144,8,18,449.2,4,4,4,12,Champions
15145,4,4,54.36,4,3,3,10,Champions
15146,164,3,36.3,1,3,2,6,Potential Customers
15147,218,2,0.14999999999999858,1,2,1,4,At Risk
15148,10,1,20.1,4,1,2,7,Loyal Customers
15149,133,1,17.0,2,1,2,5,Potential Customers
15150,17,11,200.81,3,4,4,11,Champions
15152,9,16,196.84,4,4,4,12,Champions
15153,31,1,12.48,3,1,1,5,Potential Customers
15154,74,2,-3.3999999999999995,2,2,1,5,Returned/Churned
15156,1,3,75.1,4,3,3,10,Champions
15157,3,5,28.379999999999995,4,3,2,9,Loyal Customers
15158,45,1,122.04,3,1,4,8,Loyal Customers
15159,1,34,839.4,4,4,4,12,Champions
15160,357,1,106.2,1,1,3,5,Potential Customers
15163,18,2,86.3,3,2,3,8,Loyal Customers
15164,68,3,32.92,2,3,2,7,Loyal Customers
15165,373,1,17.4,1,1,2,4,At Risk
15167,320,1,2.1,1,1,1,3,At Risk
15168,25,1,47.7,3,1,3,7,Loyal Customers
15171,324,2,0.0,1,2,1,4,Returned/Churned
15172,8,5,67.25999999999999,4,3,3,10,Champions
15174,322,1,15.6,1,1,2,4,At Risk
15175,71,1,17.4,2,1,2,5,Potential Customers
15178,260,1,19.5,1,1,2,4,At Risk
15179,18,7,194.08,3,4,4,11,Champions
15180,367,1,13.049999999999999,1,1,1,3,At Risk
15181,66,5,111.39999999999998,2,3,4,9,Loyal Customers
15182,154,2,36.6,1,2,2,5,Potential Customers
15184,29,2,17.85,3,2,2,7,Loyal Customers
15185,70,1,15.600000000000001,2,1,2,5,Potential Customers
15186,14,2,61.300000000000004,4,2,3,9,Loyal Customers
15187,1,18,1869.38,4,4,4,12,Champions
15189,1,53,3651.9,4,4,4,12,Champions
15192,119,3,84.89999999999999,2,3,3,8,Loyal Customers
15193,60,1,70.8,2,1,3,6,Potential Customers
15194,3,22,253.9,4,4,4,12,Champions
15195,2,1,3861.0,4,1,4,9,Loyal Customers
15197,8,5,57.55,4,3,3,10,Champions
15198,92,2,33.32,2,2,2,6,Potential Customers
15199,59,4,487.15,2,3,4,9,Loyal Customers
15201,78,11,162.25,2,4,4,10,Champions
15203,25,6,64.38,3,4,3,10,Champions
15204,357,1,16.5,1,1,2,4,At Risk
15205,85,3,18.240000000000002,2,3,2,7,Loyal Customers
15206,10,4,157.8,4,3,4,11,Champions
15208,1,6,162.8,4,4,4,12,Champions
15210,225,1,14.75,1,1,1,3,At Risk
15211,60,2,33.0,2,2,2,6,Potential Customers
15212,239,2,1.6500000000000004,1,2,1,4,At Risk
15213,318,3,20.25,1,3,2,6,Potential Customers
15214,1,8,127.36,4,4,4,12,Champions
15215,44,6,38.55000000000001,3,4,2,9,Loyal Customers
15216,87,1,63.6,2,1,3,6,Potential Customers
15218,10,11,578.8,4,4,4,12,Champions
15219,176,1,79.80000000000001,1,1,3,5,Potential Customers
15220,51,7,109.65,2,4,3,9,Loyal Customers
15221,366,2,62.2,1,2,3,6,Potential Customers
15222,318,1,145.0,1,1,4,6,Potential Customers
15223,225,3,70.30000000000001,1,3,3,7,Loyal Customers
15224,358,3,46.8,1,3,3,7,Loyal Customers
15225,234,1,15.0,1,1,1,3,At Risk
15226,310,1,25.5,1,1,2,4,At Risk
15227,36,5,72.48,3,3,3,9,Loyal Customers
15228,66,5,136.35,2,3,4,9,Loyal Customers
15230,239,2,94.80000000000001,1,2,3,6,Potential Customers
15232,113,2,34.0,2,2,2,6,Potential Customers
15234,276,1,15.0,1,1,1,3,At Risk
15235,217,12,187.65,1,4,4,9,Loyal Customers
15236,298,1,17.4,1,1,2,4,At Risk
15237,1,4,62.72,4,3,3,10,Champions
15238,29,5,26.79,3,3,2,8,Loyal Customers
15239,10,3,43.63,4,3,3,10,Champions
15240,44,7,123.13000000000001,3,4,4,11,Champions
15241,66,9,157.17000000000002,2,4,4,10,Champions
15243,74,1,12.48,2,1,1,4,At Risk
15244,65,2,39.599999999999994,2,2,3,7,Loyal Customers
15245,134,3,80.0,2,3,3,8,Loyal Customers
15246,238,2,27.900000000000002,1,2,2,5,Potential Customers
15247,122,1,81.6,2,1,3,6,Potential Customers
15249,31,15,321.36,3,4,4,11,Champions
15251,9,15,1151.21,4,4,4,12,Champions
15252,36,2,34.8,3,2,2,7,Loyal Customers
15253,16,6,108.2,4,4,3,11,Champions
15254,127,1,16.8,2,1,2,5,Potential Customers
15255,66,1,17.700000000000003,2,1,2,5,Potential Customers
15256,148,1,16.5,1,1,2,4,At Risk
15257,281,2,-51.1,1,2,1,4,Returned/Churned
15258,168,2,33.5,1,2,2,5,Potential Customers
15260,100,8,147.3,2,4,4,10,Champions
15261,135,1,4.5600000000000005,2,1,1,4,At Risk
15262,323,1,17.0,1,1,2,4,At Risk
15263,106,1,17.4,2,1,2,5,Potential Customers
15264,64,1,29.700000000000003,2,1,2,5,Potential Customers
15265,151,2,32.55,1,2,2,5,Potential Customers
15266,338,1,39.8,1,1,3,5,Potential Customers
15267,22,5,641.76,3,3,4,10,Champions
15269,23,1,118.80000000000001,3,1,4,8,Loyal Customers
15270,15,9,500.40999999999997,4,4,4,12,Champions
15271,7,16,179.04,4,4,4,12,Champions
15272,57,2,42.599999999999994,2,2,3,7,Loyal Customers
15274,4,2,34.8,4,2,2,8,Loyal Customers
15275,31,2,3.999999999999999,3,2,1,6,Potential Customers
15276,66,1,1.25,2,1,1,4,At Risk
15277,46,1,19.8,3,1,2,6,Potential Customers
15279,354,2,4.15,1,2,1,4,At Risk
15280,172,1,0.72,1,1,1,3,At Risk
15281,58,12,186.12,2,4,4,10,Champions
15286,49,1,59.400000000000006,3,1,3,7,Loyal Customers
15287,22,3,160.55,3,3,4,10,Champions
15288,43,5,121.35000000000001,3,3,4,10,Champions
15289,29,4,40.56,3,3,3,9,Loyal Customers
15290,4,21,553.95,4,4,4,12,Champions
15291,25,20,1014.05,3,4,4,11,Champions
15292,201,1,3.3,1,1,1,3,At Risk
15296,44,10,55.25000000000001,3,4,3,10,Champions
15297,10,4,49.3,4,3,3,10,Champions
15298,2,14,262.72,4,4,4,12,Champions
15299,67,11,3790.9,2,4,4,10,Champions
15300,64,1,15.0,2,1,1,4,At Risk
15301,50,14,877.8199999999999,3,4,4,11,Champions
15303,290,1,12.75,1,1,1,3,At Risk
15304,60,10,262.65000000000003,2,4,4,10,Champions
15306,64,3,127.2,2,3,4,9,Loyal Customers
15307,95,1,22.5,2,1,2,5,Potential Customers
15308,270,2,12.95,1,2,1,4,At Risk
15311,0,118,3973.29,4,4,4,12,Champions
15312,75,5,53.05,2,3,3,8,Loyal Customers
15313,110,1,52.0,2,1,3,6,Potential Customers
15314,199,1,5.04,1,1,1,3,At Risk
15315,64,3,14.04,2,3,1,6,Potential Customers
15316,326,1,165.0,1,1,4,6,Potential Customers
15318,3,1,9.0,4,1,1,6,Potential Customers
15319,283,1,11.9,1,1,1,3,At Risk
15320,44,1,2.95,3,1,1,5,Potential Customers
15321,49,4,105.45,3,3,3,9,Loyal Customers
15322,64,2,-8.899999999999999,2,2,1,5,Returned/Churned
15325,103,1,1.25,2,1,1,4,At Risk
15326,333,1,13.200000000000001,1,1,1,3,At Risk
15327,52,1,38.25,2,1,2,5,Potential Customers
15329,35,5,23.35,3,3,2,8,Loyal Customers
15330,32,2,163.2,3,2,4,9,Loyal Customers
15332,366,4,168.0,1,3,4,8,Loyal Customers
15333,208,1,22.5,1,1,2,4,At Risk
15334,156,3,21.54,1,3,2,6,Potential Customers
15335,53,1,2.55,2,1,1,4,At Risk
15339,66,3,12.4,2,3,1,6,Potential Customers
15341,80,1,102.0,2,1,3,6,Potential Customers
15342,116,2,1.799999999999999,2,2,1,5,Potential Customers
15343,87,1,25.5,2,1,2,5,Potential Customers
15344,0,5,31.15,4,3,2,9,Loyal Customers
15345,35,2,22.55,3,2,2,7,Loyal Customers
15346,332,1,17.85,1,1,2,4,At Risk
15347,366,1,120.0,1,1,4,6,Potential Customers
15348,72,1,15.0,2,1,1,4,At Risk
15349,158,2,18.4,1,2,2,5,Potential Customers
15350,373,1,25.200000000000003,1,1,2,4,At Risk
15351,12,10,36.169999999999995,4,4,2,10,Champions
15353,254,2,36.9,1,2,2,5,Potential Customers
15355,29,2,35.7,3,2,2,7,Loyal Customers
15356,31,10,37.3,3,4,2,9,Loyal Customers
15358,4,29,345.45,4,4,4,12,Champions
15360,39,1,29.700000000000003,3,1,2,6,Potential Customers
15361,361,1,10.2,1,1,1,3,At Risk
15363,241,2,11.849999999999998,1,2,1,4,At Risk
15364,95,2,104.75999999999999,2,2,3,7,Loyal Customers
15365,25,9,62.380000000000024,3,4,3,10,Champions
15366,75,2,45.0,2,2,3,7,Loyal Customers
15367,57,5,61.7,2,3,3,8,Loyal Customers
15368,21,1,16.5,3,1,2,6,Potential Customers
15369,144,1,-1592.49,1,1,1,3,Returned/Churned
15370,40,8,258.1,3,4,4,11,Champions
15372,137,1,88.80000000000001,2,1,3,6,Potential Customers
15373,8,13,363.2,4,4,4,12,Champions
15374,128,1,91.8,2,1,3,6,Potential Customers
15376,40,3,40.199999999999996,3,3,3,9,Loyal Customers
15379,169,8,116.5,1,4,4,9,Loyal Customers
15380,8,6,626.3000000000001,4,4,4,12,Champions
15381,213,2,349.95000000000005,1,2,4,7,Loyal Customers
15382,14,8,117.26000000000002,4,4,4,12,Champions
15384,169,3,25.200000000000003,1,3,2,6,Potential Customers
15385,40,1,12.48,3,1,1,5,Potential Customers
15386,186,1,23.400000000000002,1,1,2,4,At Risk
15388,270,1,23.4,1,1,2,4,At Risk
15389,172,1,500.0,1,1,4,6,Potential Customers
15392,4,5,75.16,4,3,3,10,Champions
15393,16,2,35.1,4,2,2,8,Loyal Customers
15394,9,4,103.0,4,3,3,10,Champions
15395,325,1,17.0,1,1,2,4,At Risk
15396,112,1,68.0,2,1,3,6,Potential Customers
15397,289,1,14.850000000000001,1,1,1,3,At Risk
15398,16,3,46.300000000000004,4,3,3,10,Champions
15399,1,3,46.5,4,3,3,10,Champions
15400,92,6,282.4,2,4,4,10,Champions
15402,148,2,64.2,1,2,3,6,Potential Customers
15405,189,1,61.199999999999996,1,1,3,5,Potential Customers
15406,18,4,-2.4499999999999993,3,3,1,7,Returned/Churned
15407,33,4,31.53,3,3,2,8,Loyal Customers
15408,264,1,4.95,1,1,1,3,At Risk
15410,84,8,219.97,2,4,4,10,Champions
15411,26,5,34.5,3,3,2,8,Loyal Customers
15412,171,1,102.0,1,1,3,5,Potential Customers
15414,9,3,74.75999999999999,4,3,3,10,Champions
15415,313,1,15.0,1,1,1,3,At Risk
15416,64,5,57.04,2,3,3,8,Loyal Customers
15417,85,1,15.6,2,1,2,5,Potential Customers
15419,24,1,10.08,3,1,1,5,Potential Customers
15421,58,4,77.8,2,3,3,8,Loyal Customers
15422,323,2,34.7,1,2,2,5,Potential Customers
15423,38,1,36.0,3,1,2,6,Potential Customers
15424,254,2,48.72,1,2,3,6,Potential Customers
15426,19,7,21.64,3,4,2,9,Loyal Customers
15427,33,3,39.9,3,3,3,9,Loyal Customers
15428,15,1,17.700000000000003,4,1,2,7,Loyal Customers
15429,26,3,-16.550000000000004,3,3,1,7,Returned/Churned
15432,23,1,12.600000000000001,3,1,1,5,Potential Customers
15433,79,3,11.36,2,3,1,6,Potential Customers
15434,8,6,76.82,4,4,3,11,Champions
15435,22,1,4.95,3,1,1,5,Potential Customers
15436,12,3,16.0,4,3,2,9,Loyal Customers
15437,262,1,3.3,1,1,1,3,At Risk
15438,131,1,11.8,2,1,1,4,At Risk
15440,54,3,12.05,2,3,1,6,Potential Customers
15442,248,1,297.0,1,1,4,6,Potential Customers
15443,1,8,63.449999999999996,4,4,3,11,Champions
15444,9,2,19.17,4,2,2,8,Loyal Customers
15445,264,1,20.4,1,1,2,4,At Risk
15447,330,1,10.2,1,1,1,3,At Risk
15448,312,1,19.9,1,1,2,4,At Risk
15449,26,5,53.900000000000006,3,3,3,9,Loyal Customers
15450,30,1,15.0,3,1,1,5,Potential Customers
15452,29,3,50.35000000000001,3,3,3,9,Loyal Customers
15453,1,7,43.85,4,4,3,11,Champions
15454,362,1,4.95,1,1,1,3,At Risk
15456,283,3,11.95,1,3,1,5,Potential Customers
15457,262,1,1.25,1,1,1,3,At Risk
15458,25,1,18.72,3,1,2,6,Potential Customers
15460,354,1,1.25,1,1,1,3,At Risk
15462,94,3,54.599999999999994,2,3,3,8,Loyal Customers
15463,29,1,6.84,3,1,1,5,Potential Customers
15464,338,1,39.95,1,1,3,5,Potential Customers
15465,19,24,3120.2999999999997,3,4,4,11,Champions
15466,85,1,5.1,2,1,1,4,At Risk
15467,9,4,34.7,4,3,2,9,Loyal Customers
15468,35,5,20.549999999999997,3,3,2,8,Loyal Customers
15469,43,4,27.200000000000006,3,3,2,8,Loyal Customers
15471,2,1,3.75,4,1,1,6,Potential Customers
15472,113,1,2.08,2,1,1,4,At Risk
15473,14,10,775.2,4,4,4,12,Champions
15475,77,1,17.85,2,1,2,5,Potential Customers
15478,40,2,62.400000000000006,3,2,3,8,Loyal Customers
15480,116,1,34.0,2,1,2,5,Potential Customers
15482,15,16,1181.3799999999999,4,4,4,12,Champions
15483,161,4,10.64,1,3,1,5,Potential Customers
15484,1,5,146.16,4,3,4,11,Champions
15485,30,3,25.62,3,3,2,8,Loyal Customers
15488,92,1,15.0,2,1,1,4,At Risk
15489,22,4,78.15,3,3,3,9,Loyal Customers
15491,95,7,171.96,2,4,4,10,Champions
15492,28,2,20.04,3,2,2,7,Loyal Customers
15493,32,7,-6.92,3,4,1,8,Returned/Churned
15494,21,2,4.2299999999999995,3,2,1,6,Potential Customers
15497,17,3,117.5,3,3,4,10,Champions
15498,0,35,219.44,4,4,4,12,Champions
15500,8,4,48.69,4,3,3,10,Champions
15502,15,23,428.4,4,4,4,12,Champions
15503,362,1,0.42,1,1,1,3,At Risk
15504,81,1,7.5,2,1,1,4,At Risk
15505,52,7,21.319999999999997,2,4,2,8,Loyal Customers
15506,22,3,10.9,3,3,1,7,Loyal Customers
15507,171,1,7.95,1,1,1,3,At Risk
15508,189,6,52.010000000000005,1,4,3,8,Loyal Customers
15510,330,1,250.0,1,1,4,6,Potential Customers
15511,11,5,25.37,4,3,2,9,Loyal Customers
15512,155,2,43.199999999999996,1,2,3,6,Potential Customers
15513,31,22,870.87,3,4,4,11,Champions
15514,12,13,291.45,4,4,4,12,Champions
15516,44,3,16.28,3,3,2,8,Loyal Customers
15517,233,1,7.56,1,1,1,3,At Risk
15518,64,13,52.7,2,4,3,9,Loyal Customers
15520,1,1,10.2,4,1,1,6,Potential Customers
15521,36,13,-25.39999999999999,3,4,1,8,Returned/Churned
15522,32,2,2.64,3,2,1,6,Potential Customers
15523,84,1,232.50000000000003,2,1,4,7,Loyal Customers
15524,24,1,440.0,3,1,4,8,Loyal Customers
15525,2,4,13.99,4,3,1,8,Loyal Customers
15526,33,2,139.29999999999998,3,2,4,9,Loyal Customers
15527,18,10,47.77000000000001,3,4,3,10,Champions
15528,254,1,3.75,1,1,1,3,At Risk
15529,22,12,129.79,3,4,4,11,Champions
15530,21,4,36.94,3,3,2,8,Loyal Customers
15531,8,2,27.35,4,2,2,8,Loyal Customers
15532,25,6,-4.299999999999997,3,4,1,8,Returned/Churned
15533,19,5,45.85,3,3,3,9,Loyal Customers
15535,173,7,-33.199999999999996,1,4,1,6,Returned/Churned
15537,163,1,1.25,1,1,1,3,At Risk
15539,7,1,6.25,4,1,1,6,Potential Customers
15540,11,1,19.5,4,1,2,7,Loyal Customers
15541,114,1,2.08,2,1,1,4,At Risk
15543,288,1,2.55,1,1,1,3,At Risk
15544,8,11,108.07000000000001,4,4,3,11,Champions
15545,54,2,9.2,2,2,1,5,Potential Customers
15547,7,14,134.12,4,4,4,12,Champions
15549,77,4,1.6000000000000014,2,3,1,6,Potential Customers
15550,4,4,29.06,4,3,2,9,Loyal Customers
15551,36,1,19.9,3,1,2,6,Potential Customers
15552,217,1,5.9,1,1,1,3,At Risk
15553,60,1,2.5,2,1,1,4,At Risk
15554,277,1,15.9,1,1,2,4,At Risk
15555,12,20,164.34,4,4,4,12,Champions
15556,24,1,11.6,3,1,1,5,Potential Customers
15557,28,1,35.7,3,1,2,6,Potential Customers
15561,11,5,202.35,4,3,4,11,Champions
15562,351,1,134.55,1,1,4,6,Potential Customers
15563,8,7,46.9,4,4,3,11,Champions
15565,50,2,33.0,3,2,2,7,Loyal Customers
15567,18,1,99.84,3,1,3,7,Loyal Customers
15568,2,3,25.909999999999997,4,3,2,9,Loyal Customers
15569,103,5,827.76,2,3,4,9,Loyal Customers
15570,7,13,152.84,4,4,4,12,Champions
15571,11,4,49.21000000000001,4,3,3,10,Champions
15572,4,7,83.69,4,4,3,11,Champions
15573,31,2,8.16,3,2,1,6,Potential Customers
15574,177,4,29.95,1,3,2,6,Potential Customers
15576,37,1,90.0,3,1,3,7,Loyal Customers
15577,151,3,28.65,1,3,2,6,Potential Customers
15578,162,1,7.95,1,1,1,3,At Risk
15579,68,2,7.49,2,2,1,5,Potential Customers
15581,120,14,2494.5,2,4,4,10,Champions
15582,24,3,47.550000000000004,3,3,3,9,Loyal Customers
15584,23,5,27.43,3,3,2,8,Loyal Customers
15585,176,1,15.9,1,1,2,4,At Risk
15587,50,4,364.32000000000005,3,3,4,10,Champions
15589,252,4,40.75,1,3,3,7,Loyal Customers
15590,289,1,-30.19,1,1,1,3,Returned/Churned
15592,46,1,12.48,3,1,1,5,Potential Customers
15593,70,1,15.0,2,1,1,4,At Risk
15594,15,6,79.92,4,4,3,11,Champions
15596,100,9,44.25,2,4,3,9,Loyal Customers
15597,29,2,9.0,3,2,1,6,Potential Customers
15598,35,3,10.0,3,3,1,7,Loyal Customers
15599,26,2,46.839999999999996,3,2,3,8,Loyal Customers
15601,11,17,332.24,4,4,4,12,Champions
15602,8,15,140.7,4,4,4,12,Champions
15603,78,1,34.56,2,1,2,5,Potential Customers
15604,52,1,14.850000000000001,2,1,1,4,At Risk
15605,36,5,75.80000000000001,3,3,3,9,Loyal Customers
15606,57,11,352.22,2,4,4,10,Champions
15607,336,1,4.5600000000000005,1,1,1,3,At Risk
15608,28,4,155.78,3,3,4,10,Champions
15609,182,2,2.8500000000000014,1,2,1,4,At Risk
15610,51,1,15.0,2,1,1,4,At Risk
15611,9,15,707.76,4,4,4,12,Champions
15612,36,2,32.0,3,2,2,7,Loyal Customers
15615,10,27,494.04,4,4,4,12,Champions
15618,32,5,69.69,3,3,3,9,Loyal Customers
15619,10,1,145.0,4,1,4,9,Loyal Customers
15620,50,6,28.95,3,4,2,9,Loyal Customers
15621,4,6,201.31,4,4,4,12,Champions
15622,3,16,104.25999999999999,4,4,3,11,Champions
15623,141,1,17.700000000000003,2,1,2,5,Potential Customers
15624,116,4,73.05000000000001,2,3,3,8,Loyal Customers
15625,100,8,40.5,2,4,3,9,Loyal Customers
15626,74,2,25.32,2,2,2,6,Potential Customers
15628,4,10,146.3,4,4,4,12,Champions
15630,45,3,53.45,3,3,3,9,Loyal Customers
15632,15,10,171.95999999999998,4,4,4,12,Champions
15634,17,1,17.700000000000003,3,1,2,6,Potential Customers
15636,89,2,50.400000000000006,2,2,3,7,Loyal Customers
15637,52,1,14.850000000000001,2,1,1,4,At Risk
15638,301,1,-60.0,1,1,1,3,Returned/Churned
15639,134,1,39.8,2,1,3,6,Potential Customers
15640,4,17,563.44,4,4,4,12,Champions
15641,105,4,49.71,2,3,3,8,Loyal Customers
15643,179,6,97.80000000000001,1,4,3,8,Loyal Customers
15644,166,4,12.600000000000001,1,3,1,5,Potential Customers
15645,18,1,0.42,3,1,1,5,Potential Customers
15646,157,4,32.800000000000004,1,3,2,6,Potential Customers
15648,204,4,28.8,1,3,2,6,Potential Customers
15649,336,2,816.0,1,2,4,7,Loyal Customers
15651,36,3,78.03999999999999,3,3,3,9,Loyal Customers
15652,91,1,30.0,2,1,2,5,Potential Customers
15653,92,2,432.11999999999995,2,2,4,8,Loyal Customers
15654,9,2,40.26,4,2,3,9,Loyal Customers
15655,233,2,5.950000000000001,1,2,1,4,At Risk
15656,45,4,68.61,3,3,3,9,Loyal Customers
15657,22,1,30.0,3,1,2,6,Potential Customers
15658,190,8,32.25,1,4,2,7,Loyal Customers
15659,43,1,15.0,3,1,1,5,Potential Customers
15660,25,12,145.34,3,4,4,11,Champions
15661,317,2,122.6,1,2,4,7,Loyal Customers
15663,106,1,14.040000000000001,2,1,1,4,At Risk
15664,50,2,-0.29999999999999893,3,2,1,6,Returned/Churned
15665,168,2,43.800000000000004,1,2,3,6,Potential Customers
15667,39,1,9.36,3,1,1,5,Potential Customers
15668,217,1,76.32000000000001,1,1,3,5,Potential Customers
15669,40,5,144.17000000000002,3,3,4,10,Champions
15670,296,1,17.700000000000003,1,1,2,4,At Risk
15671,18,10,465.8,3,4,4,11,Champions
15673,88,4,66.0,2,3,3,8,Loyal Customers
15674,73,8,37.50999999999998,2,4,2,8,Loyal Customers
15675,81,3,49.2,2,3,3,8,Loyal Customers
15676,9,5,19.91,4,3,2,9,Loyal Customers
15677,49,1,15.0,3,1,1,5,Potential Customers
15678,52,1,22.5,2,1,2,5,Potential Customers
15679,24,4,41.760000000000005,3,3,3,9,Loyal Customers
15680,9,3,47.3,4,3,3,10,Champions
15681,18,6,93.06,3,4,3,10,Champions
15683,117,1,20.8,2,1,2,5,Potential Customers
15687,8,11,165.3,4,4,4,12,Champions
15689,119,2,45.0,2,2,3,7,Loyal Customers
15690,4,2,51.48,4,2,3,9,Loyal Customers
15691,252,1,45.0,1,1,3,5,Potential Customers
15692,28,1,6.959999999999999,3,1,1,5,Potential Customers
15694,0,15,1619.44,4,4,4,12,Champions
15695,266,2,55.95,1,2,3,6,Potential Customers
15696,33,12,69.65,3,4,3,10,Champions
15699,17,1,12.5,3,1,1,5,Potential Customers
15700,172,3,-3.9999999999999987,1,3,1,5,Returned/Churned
15701,2,4,41.9,4,3,3,10,Champions
15703,264,1,23.4,1,1,2,4,At Risk
15704,140,4,91.8,2,3,3,8,Loyal Customers
15705,201,1,60.0,1,1,3,5,Potential Customers
15706,59,7,111.55000000000001,2,4,4,10,Champions
15707,35,4,21.75,3,3,2,8,Loyal Customers
15708,40,11,86.12,3,4,3,10,Champions
15709,283,1,38.160000000000004,1,1,2,4,At Risk
15712,9,5,258.66,4,3,4,11,Champions
15713,143,3,22.45,2,3,2,7,Loyal Customers
15714,11,2,30.240000000000002,4,2,2,8,Loyal Customers
15716,145,4,33.620000000000005,1,3,2,6,Potential Customers
15717,234,1,35.400000000000006,1,1,2,4,At Risk
15719,32,14,113.71000000000001,3,4,4,11,Champions
15720,24,1,3.75,3,1,1,5,Potential Customers
15721,11,1,0.85,4,1,1,6,Potential Customers
15722,35,6,138.95,3,4,4,11,Champions
15723,364,1,1.25,1,1,1,3,At Risk
15724,201,3,38.75,1,3,2,6,Potential Customers
15725,15,1,33.0,4,1,2,7,Loyal Customers
15727,16,7,125.5,4,4,4,12,Champions
15728,49,1,-9.3,3,1,1,5,Returned/Churned
15729,198,2,-8.0,1,2,1,4,Returned/Churned
15730,65,4,36.0,2,3,2,7,Loyal Customers
15732,212,2,32.1,1,2,2,5,Potential Customers
15733,282,1,19.799999999999997,1,1,2,4,At Risk
15734,114,2,61.5,2,2,3,7,Loyal Customers
15737,14,12,130.0,4,4,4,12,Champions
15738,18,19,301.07,3,4,4,11,Champions
15739,66,1,23.8,2,1,2,5,Potential Customers
15740,49,1,9.36,3,1,1,5,Potential Customers
15743,16,4,37.35,4,3,2,9,Loyal Customers
15744,77,1,13.919999999999998,2,1,1,4,At Risk
15745,8,6,100.65,4,4,3,11,Champions
15746,134,2,4.830000000000002,2,2,1,5,Potential Customers
15747,12,3,23.6,4,3,2,9,Loyal Customers
15748,40,1,5.8,3,1,1,5,Potential Customers
15749,235,4,8346.0,1,3,4,8,Loyal Customers
15750,2,9,90.31,4,4,3,11,Champions
15752,39,8,72.64000000000001,3,4,3,10,Champions
15753,304,1,79.2,1,1,3,5,Potential Customers
15754,50,4,46.839999999999996,3,3,3,9,Loyal Customers
15755,1,8,101.63,4,4,3,11,Champions
15756,61,4,10.01,2,3,1,6,Potential Customers
15757,65,2,50.7,2,2,3,7,Loyal Customers
15758,24,1,29.700000000000003,3,1,2,6,Potential Customers
15759,218,3,123.2,1,3,4,8,Loyal Customers
15762,65,2,39.84,2,2,3,7,Loyal Customers
15763,31,3,17.1,3,3,2,8,Loyal Customers
15764,81,10,66.7,2,4,3,9,Loyal Customers
15766,64,1,25.5,2,1,2,5,Potential Customers
15768,115,4,6.349999999999998,2,3,1,6,Potential Customers
15769,7,29,10185.24,4,4,4,12,Champions
15773,5,1,7.08,4,1,1,6,Potential Customers
15774,68,1,13.9,2,1,1,4,At Risk
15775,245,1,15.0,1,1,1,3,At Risk
15776,133,1,7.4399999999999995,2,1,1,4,At Risk
15777,241,5,423.15,1,3,4,8,Loyal Customers
15780,183,3,62.85,1,3,3,7,Loyal Customers
15781,25,4,51.25000000000001,3,3,3,9,Loyal Customers
15782,9,4,270.6,4,3,4,11,Champions
15783,10,1,15.7,4,1,2,7,Loyal Customers
15785,29,8,60.339999999999996,3,4,3,10,Champions
15786,43,5,35.849999999999994,3,3,2,8,Loyal Customers
15787,26,3,28.05,3,3,2,8,Loyal Customers
15789,358,1,15.6,1,1,2,4,At Risk
15790,10,1,5.9,4,1,1,6,Potential Customers
15791,43,3,41.55,3,3,3,9,Loyal Customers
15793,9,4,356.07000000000005,4,3,4,11,Champions
15795,149,1,6.959999999999999,1,1,1,3,At Risk
15796,1,10,126.75,4,4,4,12,Champions
15797,113,4,957.0,2,3,4,9,Loyal Customers
15799,75,3,21.9,2,3,2,7,Loyal Customers
15800,107,2,15.18,2,2,2,6,Potential Customers
15801,46,4,45.75,3,3,3,9,Loyal Customers
15802,142,3,-451.42,2,3,1,6,Returned/Churned
15803,51,1,17.0,2,1,2,5,Potential Customers
15804,0,19,-128.7,4,4,1,9,Returned/Churned
15805,23,20,303.41,3,4,4,11,Champions
15806,46,3,36.93,3,3,2,8,Loyal Customers
15807,50,3,77.4,3,3,3,9,Loyal Customers
15808,306,5,185.1,1,3,4,8,Loyal Customers
15809,35,6,65.8,3,4,3,10,Champions
15810,78,7,40.42,2,4,3,9,Loyal Customers
15811,17,9,99.37,3,4,3,10,Champions
15812,107,5,590.25,2,3,4,9,Loyal Customers
15813,207,2,40.35,1,2,3,6,Potential Customers
15814,3,6,-9.939999999999998,4,4,1,9,Returned/Churned
15815,63,5,376.1,2,3,4,9,Loyal Customers
15819,49,4,66.44,3,3,3,9,Loyal Customers
15820,319,1,1.25,1,1,1,3,At Risk
15821,44,2,4.8,3,2,1,6,Potential Customers
15822,3,2,35.85,4,2,2,8,Loyal Customers
15823,337,2,-15.0,1,2,1,4,Returned/Churned
15825,172,1,25.5,1,1,2,4,At Risk
15826,51,4,73.95,2,3,3,8,Loyal Customers
15827,73,20,166.65,2,4,4,10,Champions
15829,99,2,9.6,2,2,1,5,Potential Customers
15830,29,2,0.8599999999999994,3,2,1,6,Potential Customers
15831,58,4,-10.74,2,3,1,6,Returned/Churned
15832,254,1,12.5,1,1,1,3,At Risk
15834,70,6,9.95,2,4,1,7,Loyal Customers
15835,44,4,111.3,3,3,4,10,Champions
15836,45,2,0.0,3,2,1,6,Returned/Churned
15837,64,1,16.6,2,1,2,5,Potential Customers
15838,11,21,3199.34,4,4,4,12,Champions
15839,25,5,26.310000000000002,3,3,2,8,Loyal Customers
15840,58,3,3.8999999999999986,2,3,1,6,Potential Customers
15841,64,6,225.22,2,4,4,10,Champions
15843,303,1,14.850000000000001,1,1,1,3,At Risk
15844,46,1,20.28,3,1,2,6,Potential Customers
15845,17,10,164.7,3,4,4,11,Champions
15847,38,2,26.200000000000003,3,2,2,7,Loyal Customers
15850,19,2,5.21,3,2,1,6,Potential Customers
15852,186,2,70.25,1,2,3,6,Potential Customers
15853,51,1,2.08,2,1,1,4,At Risk
15854,4,12,862.5500000000001,4,4,4,12,Champions
15855,136,5,40.15,2,3,3,8,Loyal Customers
15856,4,31,893.16,4,4,4,12,Champions
15857,18,1,15.0,3,1,1,5,Potential Customers
15858,15,5,36.07,4,3,2,9,Loyal Customers
15860,40,8,57.480000000000004,3,4,3,10,Champions
15861,12,9,62.26999999999999,4,4,3,11,Champions
15862,8,4,36.800000000000004,4,3,2,9,Loyal Customers
15863,25,2,5.0,3,2,1,6,Potential Customers
15864,22,8,706.37,3,4,4,11,Champions
15865,40,3,139.8,3,3,4,10,Champions
15866,101,1,16.95,2,1,2,5,Potential Customers
15867,5,16,149.94,4,4,4,12,Champions
15869,277,2,18.0,1,2,2,5,Potential Customers
15870,32,1,3.75,3,1,1,5,Potential Customers
15872,14,2,10.35,4,2,1,7,Loyal Customers
15874,63,9,495.5,2,4,4,10,Champions
15877,1,3,-3.8499999999999996,4,3,1,8,Returned/Churned
15880,369,2,-13.05,1,2,1,4,Returned/Churned
15881,312,8,-4.599999999999996,1,4,1,6,Returned/Churned
15882,198,5,96.2,1,3,3,7,Loyal Customers
15883,2,2,21.330000000000002,4,2,2,8,Loyal Customers
15885,92,3,49.8,2,3,3,8,Loyal Customers
15886,60,1,5.1,2,1,1,4,At Risk
15888,79,2,8.98,2,2,1,5,Potential Customers
15889,156,2,22.25,1,2,2,5,Potential Customers
15891,226,1,2.55,1,1,1,3,At Risk
15894,253,2,25.26,1,2,2,5,Potential Customers
15895,149,1,137.16,1,1,4,6,Potential Customers
15897,194,2,12.7,1,2,1,4,At Risk
15898,1,6,344.75,4,4,4,12,Champions
15899,368,1,12.75,1,1,1,3,At Risk
15900,23,1,9.36,3,1,1,5,Potential Customers
15901,16,3,19.7,4,3,2,9,Loyal Customers
15903,9,8,526.74,4,4,4,12,Champions
15904,8,1,4.68,4,1,1,6,Potential Customers
15906,19,8,12.799999999999994,3,4,1,8,Loyal Customers
15907,3,3,13.65,4,3,1,8,Loyal Customers
15909,173,1,19.799999999999997,1,1,2,4,At Risk
15910,0,8,55.410000000000004,4,4,3,11,Champions
15912,178,2,30.42,1,2,2,5,Potential Customers
15916,16,10,115.67999999999999,4,4,4,12,Champions
15917,247,1,10.2,1,1,1,3,At Risk
15918,190,2,40.5,1,2,3,6,Potential Customers
15919,19,2,4.27,3,2,1,6,Potential Customers
15920,154,4,9.25,1,3,1,5,Potential Customers
15921,172,1,10.2,1,1,1,3,At Risk
15922,372,2,69.7,1,2,3,6,Potential Customers
15923,372,1,4.75,1,1,1,3,At Risk
15925,194,1,38.25,1,1,2,4,At Risk
15930,67,1,16.5,2,1,2,5,Potential Customers
15932,4,11,105.77,4,4,3,11,Champions
15933,21,3,42.510000000000005,3,3,3,9,Loyal Customers
15935,239,2,324.62,1,2,4,7,Loyal Customers
15937,64,1,14.850000000000001,2,1,1,4,At Risk
15938,112,5,182.8,2,3,4,9,Loyal Customers
15939,89,16,933.77,2,4,4,10,Champions
15940,311,2,31.799999999999997,1,2,2,5,Potential Customers
15942,133,1,10.08,2,1,1,4,At Risk
15944,276,1,17.700000000000003,1,1,2,4,At Risk
15945,365,1,167.4,1,1,4,6,Potential Customers
15947,82,1,179.0,2,1,4,7,Loyal Customers
15948,8,2,35.1,4,2,2,8,Loyal Customers
15949,16,2,30.119999999999997,4,2,2,8,Loyal Customers
15950,1,5,67.4,4,3,3,10,Champions
15951,1,3,12.05,4,3,1,8,Loyal Customers
15952,33,4,42.85,3,3,3,9,Loyal Customers
15953,15,10,245.7,4,4,4,12,Champions
15955,24,16,306.51,3,4,4,11,Champions
15957,31,1,4.16,3,1,1,5,Potential Customers
15958,74,1,3.95,2,1,1,4,At Risk
15963,19,2,29.22,3,2,2,7,Loyal Customers
15965,17,4,33.910000000000004,3,3,2,8,Loyal Customers
15967,23,2,15.15,3,2,2,7,Loyal Customers
15969,2,4,1.2000000000000028,4,3,1,8,Loyal Customers
15970,303,1,16.5,1,1,2,4,At Risk
15971,17,12,2427.45,3,4,4,11,Champions
15973,235,3,-190.64999999999998,1,3,1,5,Returned/Churned
15974,39,8,107.97999999999999,3,4,3,10,Champions
15975,84,1,17.700000000000003,2,1,2,5,Potential Customers
15976,165,2,18.15,1,2,2,5,Potential Customers
15977,17,2,23.1,3,2,2,7,Loyal Customers
15978,77,1,20.8,2,1,2,5,Potential Customers
15980,88,3,120.63999999999999,2,3,4,9,Loyal Customers
15981,24,8,377.79999999999995,3,4,4,11,Champions
15983,22,4,27.29,3,3,2,8,Loyal Customers
15984,2,11,186.99,4,4,4,12,Champions
15985,123,3,-68.1,2,3,1,6,Returned/Churned
15986,30,1,13.52,3,1,1,5,Potential Customers
15987,12,7,512.8000000000001,4,4,4,12,Champions
15988,19,1,19.95,3,1,2,6,Potential Customers
15990,44,2,67.5,3,2,3,8,Loyal Customers
15992,3,1,14.95,4,1,1,6,Potential Customers
15993,8,10,60.8,4,4,3,11,Champions
15994,54,1,15.0,2,1,1,4,At Risk
15996,88,7,39.19,2,4,2,8,Loyal Customers
15998,36,6,63.15,3,4,3,10,Champions
16000,2,3,5238.9,4,3,4,11,Champions
16003,29,5,177.1,3,3,4,10,Champions
16005,12,4,13.549999999999999,4,3,1,8,Loyal Customers
16006,211,1,23.099999999999998,1,1,2,4,At Risk
16007,47,4,31.35,3,3,2,8,Loyal Customers
16008,23,3,38.45,3,3,2,8,Loyal Customers
16009,22,4,102.14,3,3,3,9,Loyal Customers
16010,245,3,12.74,1,3,1,5,Potential Customers
16011,8,16,359.11,4,4,4,12,Champions
16012,35,3,49.760000000000005,3,3,3,9,Loyal Customers
16013,3,54,15437.88,4,4,4,12,Champions
16014,35,4,25.15,3,3,2,8,Loyal Customers
16015,3,4,90.08000000000001,4,3,3,10,Champions
16016,3,10,35.61,4,4,2,10,Champions
16017,47,1,9.899999999999999,3,1,1,5,Potential Customers
16018,39,2,34.349999999999994,3,2,2,7,Loyal Customers
16019,1,10,368.27,4,4,4,12,Champions
16020,16,3,135.9,4,3,4,11,Champions
16022,260,1,7.95,1,1,1,3,At Risk
16023,46,3,15.55,3,3,2,8,Loyal Customers
16024,12,1,4.95,4,1,1,6,Potential Customers
16025,29,1,14.940000000000001,3,1,1,5,Potential Customers
16026,43,1,6.25,3,1,1,5,Potential Customers
16027,91,7,404.77,2,4,4,10,Champions
16029,38,76,7660.93,3,4,4,11,Champions
16030,309,1,9.75,1,1,1,3,At Risk
16031,92,2,20.45,2,2,2,6,Potential Customers
16033,5,27,254.01,4,4,4,12,Champions
16034,196,3,89.0,1,3,3,7,Loyal Customers
16036,87,2,90.84,2,2,3,7,Loyal Customers
16037,269,3,55.199999999999996,1,3,3,7,Loyal Customers
16038,7,4,66.30000000000001,4,3,3,10,Champions
16040,65,3,65.4,2,3,3,8,Loyal Customers
16041,30,3,1580.0,3,3,4,10,Champions
16042,22,7,51.4,3,4,3,10,Champions
16043,37,4,124.5,3,3,4,10,Champions
16045,119,4,68.4,2,3,3,8,Loyal Customers
16048,85,3,42.690000000000005,2,3,3,8,Loyal Customers
16049,40,3,2.0100000000000002,3,3,1,7,Loyal Customers
16050,173,1,24.900000000000002,1,1,2,4,At Risk
16052,54,1,4.95,2,1,1,4,At Risk
16053,32,2,35.8,3,2,2,7,Loyal Customers
16054,145,1,7.95,1,1,1,3,At Risk
16055,220,1,12.75,1,1,1,3,At Risk
16056,45,1,9.95,3,1,1,5,Potential Customers
16057,4,10,94.9,4,4,3,11,Champions
16059,65,6,59.45,2,4,3,9,Loyal Customers
16061,269,1,-29.95,1,1,1,3,Returned/Churned
16062,9,4,50.019999999999996,4,3,3,10,Champions
16063,260,1,17.4,1,1,2,4,At Risk
16065,365,1,0.85,1,1,1,3,At Risk
16066,16,5,73.48,4,3,3,10,Champions
16070,22,2,102.16,3,2,3,8,Loyal Customers
16071,44,1,19.799999999999997,3,1,2,6,Potential Customers
16072,288,1,44.550000000000004,1,1,3,5,Potential Customers
16073,291,2,94.35,1,2,3,6,Potential Customers
16076,3,11,199.53,4,4,4,12,Champions
16078,283,1,79.2,1,1,3,5,Potential Customers
16079,16,3,595.9200000000001,4,3,4,11,Champions
16080,81,3,26.240000000000002,2,3,2,7,Loyal Customers
16081,56,5,69.95,2,3,3,8,Loyal Customers
16083,100,2,63.2,2,2,3,7,Loyal Customers
16084,299,1,0.85,1,1,1,3,At Risk
16085,23,5,40.47,3,3,3,9,Loyal Customers
16086,59,6,95.75999999999999,2,4,3,9,Loyal Customers
16091,154,2,40.6,1,2,3,6,Potential Customers
16092,98,5,6.479999999999997,2,3,1,6,Potential Customers
16093,106,1,17.0,2,1,2,5,Potential Customers
16094,11,6,74.3,4,4,3,11,Champions
16096,264,1,10.08,1,1,1,3,At Risk
16097,240,1,30.0,1,1,2,4,At Risk
16098,87,7,344.55,2,4,4,10,Champions
16099,50,3,65.8,3,3,3,9,Loyal Customers
16101,9,3,5.85,4,3,1,8,Loyal Customers
16102,42,3,128.8,3,3,4,10,Champions
16103,7,6,157.3,4,4,4,12,Champions
16104,61,1,17.85,2,1,2,5,Potential Customers
16105,248,1,15.6,1,1,2,4,At Risk
16106,65,1,19.799999999999997,2,1,2,5,Potential Customers
16107,17,7,636.0,3,4,4,11,Champions
16108,84,2,-1.4399999999999977,2,2,1,5,Returned/Churned
16109,218,2,126.96,1,2,4,7,Loyal Customers
16110,45,3,18.95,3,3,2,8,Loyal Customers
16112,143,4,58.72,2,3,3,8,Loyal Customers
16113,183,1,15.12,1,1,2,4,At Risk
16114,170,1,17.700000000000003,1,1,2,4,At Risk
16115,9,8,49.76,4,4,3,11,Champions
16116,205,2,-6.379999999999999,1,2,1,4,Returned/Churned
16117,189,1,7.8,1,1,1,3,At Risk
16119,8,2,27.78,4,2,2,8,Loyal Customers
16120,59,5,180.55,2,3,4,9,Loyal Customers
16121,57,2,7.15,2,2,1,5,Potential Customers
16122,73,4,167.16000000000003,2,3,4,9,Loyal Customers
16123,51,1,15.0,2,1,1,4,At Risk
16124,316,2,25.4,1,2,2,5,Potential Customers
16125,367,1,15.9,1,1,2,4,At Risk
16126,29,4,227.4,3,3,4,10,Champions
16127,39,1,19.5,3,1,2,6,Potential Customers
16128,17,5,123.58000000000001,3,3,4,10,Champions
16131,51,6,167.24,2,4,4,10,Champions
16133,3,46,1417.9,4,4,4,12,Champions
16134,21,3,15.3,3,3,2,8,Loyal Customers
16135,262,1,175.2,1,1,4,6,Potential Customers
16136,59,3,85.88000000000001,2,3,3,8,Loyal Customers
16138,368,1,-7.95,1,1,1,3,Returned/Churned
16139,18,3,50.519999999999996,3,3,3,9,Loyal Customers
16140,52,4,112.27,2,3,4,9,Loyal Customers
16141,88,1,17.85,2,1,2,5,Potential Customers
16142,249,1,19.8,1,1,2,4,At Risk
16143,3,7,99.2,4,4,3,11,Champions
16144,246,1,175.2,1,1,4,6,Potential Customers
16145,8,18,182.45000000000002,4,4,4,12,Champions
16146,157,3,247.8,1,3,4,8,Loyal Customers
16147,133,1,16.5,2,1,2,5,Potential Customers
16148,296,1,76.32000000000001,1,1,3,5,Potential Customers
16149,4,2,29.52,4,2,2,8,Loyal Customers
16150,38,10,45.2,3,4,3,10,Champions
16152,268,1,81.6,1,1,3,5,Potential Customers
16153,49,5,75.0,3,3,3,9,Loyal Customers
16156,8,13,86.59,4,4,3,11,Champions
16157,15,4,91.5,4,3,3,10,Champions
16159,281,1,15.0,1,1,1,3,At Risk
16160,64,4,110.61,2,3,4,9,Loyal Customers
16161,1,26,110.47,4,4,4,12,Champions
16162,252,1,25.5,1,1,2,4,At Risk
16163,225,3,204.0,1,3,4,8,Loyal Customers
16164,17,4,28.129999999999995,3,3,2,8,Loyal Customers
16168,10,28,1402.76,4,4,4,12,Champions
16169,8,4,79.12,4,3,3,10,Champions
16170,50,7,124.3,3,4,4,11,Champions
16171,59,1,23.4,2,1,2,5,Potential Customers
16172,95,5,105.60000000000001,2,3,3,8,Loyal Customers
16173,15,7,106.0,4,4,3,11,Champions
16174,126,3,439.8,2,3,4,9,Loyal Customers
16175,94,4,55.47,2,3,3,8,Loyal Customers
16177,50,1,23.4,3,1,2,6,Potential Customers
16178,138,1,17.4,2,1,2,5,Potential Customers
16179,60,1,5.04,2,1,1,4,At Risk
16180,100,10,364.85,2,4,4,10,Champions
16181,73,1,11.9,2,1,1,4,At Risk
16182,72,4,862.0,2,3,4,9,Loyal Customers
16183,67,1,34.68,2,1,2,5,Potential Customers
16184,64,7,119.05000000000001,2,4,4,10,Champions
16185,16,2,47.25,4,2,3,9,Loyal Customers
16186,22,13,182.22,3,4,4,11,Champions
16187,31,17,398.46000000000004,3,4,4,11,Champions
16188,44,4,52.09,3,3,3,9,Loyal Customers
16189,15,2,34.8,4,2,2,8,Loyal Customers
16190,40,1,27.04,3,1,2,6,Potential Customers
16191,2,25,607.9899999999999,4,4,4,12,Champions
16193,236,1,25.200000000000003,1,1,2,4,At Risk
16198,75,1,20.28,2,1,2,5,Potential Customers
16200,4,2,35.15,4,2,2,8,Loyal Customers
16201,3,5,67.07,4,3,3,10,Champions
16202,360,1,14.850000000000001,1,1,1,3,At Risk
16203,58,5,58.95,2,3,3,8,Loyal Customers
16204,23,1,8.32,3,1,1,5,Potential Customers
16205,30,4,106.55,3,3,3,9,Loyal Customers
16206,54,4,75.73,2,3,3,8,Loyal Customers
16207,25,1,50.0,3,1,3,7,Loyal Customers
16208,44,2,5.52,3,2,1,6,Potential Customers
16209,88,5,1422.72,2,3,4,9,Loyal Customers
16210,1,18,5112.96,4,4,4,12,Champions
16211,81,2,25.599999999999998,2,2,2,6,Potential Customers
16212,19,3,26.55,3,3,2,8,Loyal Customers
16213,78,1,11.7,2,1,1,4,At Risk
16214,170,3,157.20000000000002,1,3,4,8,Loyal Customers
16215,80,1,15.0,2,1,1,4,At Risk
16216,267,1,16.8,1,1,2,4,At Risk
16217,235,4,21.290000000000006,1,3,2,6,Potential Customers
16218,29,8,379.15,3,4,4,11,Champions
16221,36,3,52.05,3,3,3,9,Loyal Customers
16222,318,1,4.2,1,1,1,3,At Risk
16224,57,4,65.1,2,3,3,8,Loyal Customers
16225,44,5,96.66000000000001,3,3,3,9,Loyal Customers
16226,203,3,62.7,1,3,3,7,Loyal Customers
16227,219,2,11.800000000000002,1,2,1,4,At Risk
16229,87,2,80.2,2,2,3,7,Loyal Customers
16230,189,2,26.46,1,2,2,5,Potential Customers
16232,32,5,102.3,3,3,3,9,Loyal Customers
16233,71,5,80.73,2,3,3,8,Loyal Customers
16235,40,6,84.69,3,4,3,10,Champions
16236,78,1,15.9,2,1,2,5,Potential Customers
16239,56,3,48.400000000000006,2,3,3,8,Loyal Customers
16240,8,5,292.45,4,3,4,11,Champions
16241,9,13,113.9,4,4,4,12,Champions
16242,8,8,109.78,4,4,3,11,Champions
16243,33,2,92.5,3,2,3,8,Loyal Customers
16244,211,2,27.2,1,2,2,5,Potential Customers
16245,23,5,8.549999999999997,3,3,1,7,Loyal Customers
16247,170,1,4.95,1,1,1,3,At Risk
16248,61,1,25.200000000000003,2,1,2,5,Potential Customers
16249,52,5,111.7,2,3,4,9,Loyal Customers
16250,261,2,26.35,1,2,2,5,Potential Customers
16252,366,1,-26.0,1,1,1,3,Returned/Churned
16253,31,3,81.35999999999999,3,3,3,9,Loyal Customers
16255,16,10,79.24,4,4,3,11,Champions
16256,257,2,82.2,1,2,3,6,Potential Customers
16257,176,1,21.95,1,1,2,4,At Risk
16258,45,5,408.86,3,3,4,10,Champions
16260,50,1,70.8,3,1,3,7,Loyal Customers
16261,17,4,14.530000000000001,3,3,1,7,Loyal Customers
16262,360,1,-7.5,1,1,1,3,Returned/Churned
16265,9,11,294.58,4,4,4,12,Champions
16266,73,7,74.5,2,4,3,9,Loyal Customers
16268,71,2,33.9,2,2,2,6,Potential Customers
16270,353,1,30.0,1,1,2,4,At Risk
16271,2,6,60.82000000000001,4,4,3,11,Champions
16272,116,1,20.8,2,1,2,5,Potential Customers
16274,373,1,8.5,1,1,1,3,At Risk
16275,196,1,12.75,1,1,1,3,At Risk
16276,176,1,532.8000000000001,1,1,4,6,Potential Customers
16278,23,3,191.45,3,3,4,10,Champions
16279,21,4,37.8,3,3,2,8,Loyal Customers
16281,72,1,50.0,2,1,3,6,Potential Customers
16282,339,1,34.0,1,1,2,4,At Risk
16283,5,7,29.669999999999995,4,4,2,10,Champions
16284,31,2,2.73,3,2,1,6,Potential Customers
16287,169,1,15.600000000000001,1,1,2,4,At Risk
16292,117,2,28.55,2,2,2,6,Potential Customers
16293,8,12,134.51999999999998,4,4,4,12,Champions
16295,9,4,63.900000000000006,4,3,3,10,Champions
16297,212,4,-11.649999999999997,1,3,1,5,Returned/Churned
16298,22,3,128.10000000000002,3,3,4,10,Champions
16302,107,2,-0.4800000000000004,2,2,1,5,Returned/Churned
16303,25,4,138.15,3,3,4,10,Champions
16305,138,1,19.799999999999997,2,1,2,5,Potential Customers
16306,213,9,76.02000000000001,1,4,3,8,Loyal Customers
16308,37,4,2560.0,3,3,4,10,Champions
16309,91,3,10.09,2,3,1,6,Potential Customers
16311,17,2,38.72,3,2,2,7,Loyal Customers
16313,3,2,26.28,4,2,2,8,Loyal Customers
16315,330,1,17.88,1,1,2,4,At Risk
16316,64,12,-55.089999999999996,2,4,1,7,Returned/Churned
16317,119,3,55.5,2,3,3,8,Loyal Customers
16318,35,1,19.799999999999997,3,1,2,6,Potential Customers
16319,217,1,142.8,1,1,4,6,Potential Customers
16320,172,2,39.96,1,2,3,6,Potential Customers
16321,72,7,106.20000000000002,2,4,3,9,Loyal Customers
16322,1,2,17.5,4,2,2,8,Loyal Customers
16323,196,1,207.50000000000003,1,1,4,6,Potential Customers
16324,128,3,17.4,2,3,2,7,Loyal Customers
16325,44,5,19.800000000000008,3,3,2,8,Loyal Customers
16326,5,15,111.8,4,4,4,12,Champions
16327,14,6,77.80000000000001,4,4,3,11,Champions
16330,17,4,-0.7400000000000007,3,3,1,7,Returned/Churned
16332,28,8,32.33,3,4,2,9,Loyal Customers
16333,7,22,14418.960000000001,4,4,4,12,Champions
16337,36,1,19.8,3,1,2,6,Potential Customers
16338,157,1,11.9,1,1,1,3,At Risk
16339,284,1,1.45,1,1,1,3,At Risk
16340,107,1,0.65,2,1,1,4,At Risk
16341,24,6,94.53999999999999,3,4,3,10,Champions
16342,75,4,82.56,2,3,3,8,Loyal Customers
16343,16,2,19.95,4,2,2,8,Loyal Customers
16344,158,1,35.7,1,1,2,4,At Risk
16345,44,1,100.0,3,1,3,7,Loyal Customers
16347,11,2,15.899999999999999,4,2,2,8,Loyal Customers
16348,32,7,64.63,3,4,3,10,Champions
16349,290,1,4.25,1,1,1,3,At Risk
16350,21,5,80.0,3,3,3,9,Loyal Customers
16351,332,1,19.5,1,1,2,4,At Risk
16352,17,2,30.6,3,2,2,7,Loyal Customers
16353,3,23,3882.0000000000005,4,4,4,12,Champions
16354,63,2,41.6,2,2,3,7,Loyal Customers
16356,197,4,32.65,1,3,2,6,Potential Customers
16357,33,3,93.0,3,3,3,9,Loyal Customers
16358,1,5,85.05000000000001,4,3,3,10,Champions
16359,7,12,475.06,4,4,4,12,Champions
16360,4,8,3.9599999999999995,4,4,1,9,Loyal Customers
16361,9,4,34.54,4,3,2,9,Loyal Customers
16362,32,9,8.75,3,4,1,8,Loyal Customers
16363,53,1,35.400000000000006,2,1,2,5,Potential Customers
16364,11,2,14.849999999999998,4,2,1,7,Loyal Customers
16365,17,9,372.84999999999997,3,4,4,11,Champions
16366,18,1,30.0,3,1,2,6,Potential Customers
16367,37,2,18.7,3,2,2,7,Loyal Customers
16368,2,2,17.44,4,2,2,8,Loyal Customers
16369,18,3,52.900000000000006,3,3,3,9,Loyal Customers
16370,82,4,59.3,2,3,3,8,Loyal Customers
16372,33,2,12.15,3,2,1,6,Potential Customers
16374,66,2,4.18,2,2,1,5,Potential Customers
16376,8,3,11.260000000000002,4,3,1,8,Loyal Customers
16377,267,1,180.0,1,1,4,6,Potential Customers
16378,247,3,45.15,1,3,3,7,Loyal Customers
16379,4,5,114.46,4,3,4,11,Champions
16380,61,1,100.0,2,1,3,6,Potential Customers
16383,74,2,20.4,2,2,2,6,Potential Customers
16384,89,2,34.7,2,2,2,6,Potential Customers
16385,60,3,16.63,2,3,2,7,Loyal Customers
16386,28,2,10.85,3,2,1,6,Potential Customers
16387,322,1,15.0,1,1,1,3,At Risk
16389,53,5,147.60000000000002,2,3,4,9,Loyal Customers
16392,269,1,5.0,1,1,1,3,At Risk
16393,2,20,85.46,4,4,3,11,Champions
16394,50,9,175.17,3,4,4,11,Champions
16395,60,5,33.0,2,3,2,7,Loyal Customers
16398,144,4,54.65,1,3,3,7,Loyal Customers
16399,19,2,13.65,3,2,1,6,Potential Customers
16400,94,1,15.0,2,1,1,4,At Risk
16401,1,20,447.13,4,4,4,12,Champions
16402,264,2,19.1,1,2,2,5,Potential Customers
16403,302,2,14.85,1,2,1,4,At Risk
16404,70,1,15.600000000000001,2,1,2,5,Potential Customers
16405,302,2,68.65,1,2,3,6,Potential Customers
16406,18,1,2.55,3,1,1,5,Potential Customers
16407,12,10,137.6,4,4,4,12,Champions
16409,36,5,62.9,3,3,3,9,Loyal Customers
16411,19,2,7.6499999999999995,3,2,1,6,Potential Customers
16412,53,1,16.6,2,1,2,5,Potential Customers
16413,56,1,5.9,2,1,1,4,At Risk
16414,21,2,31.8,3,2,2,7,Loyal Customers
16415,44,1,2.1,3,1,1,5,Potential Customers
16416,26,4,154.17,3,3,4,10,Champions
16418,44,3,23.35,3,3,2,8,Loyal Customers
16419,112,7,137.78,2,4,4,10,Champions
16422,17,75,4069.81,3,4,4,11,Champions
16423,24,1,5.04,3,1,1,5,Potential Customers
16424,191,2,-35.1,1,2,1,4,Returned/Churned
16425,302,1,31.8,1,1,2,4,At Risk
16426,2,10,160.75,4,4,4,12,Champions
16427,263,2,20.639999999999997,1,2,2,5,Potential Customers
16428,81,1,-2.95,2,1,1,4,Returned/Churned
16429,106,1,4.95,2,1,1,4,At Risk
16430,57,1,25.0,2,1,2,5,Potential Customers
16431,213,3,16.13,1,3,2,6,Potential Customers
16432,64,1,30.599999999999998,2,1,2,5,Potential Customers
16433,28,1,6.76,3,1,1,5,Potential Customers
16434,29,7,110.03,3,4,3,10,Champions
16438,5,5,57.400000000000006,4,3,3,10,Champions
16440,7,5,61.339999999999996,4,3,3,10,Champions
16441,67,2,27.1,2,2,2,6,Potential Customers
16442,1,3,8.91,4,3,1,8,Loyal Customers
16444,46,5,16.15,3,3,2,8,Loyal Customers
16445,33,1,1.25,3,1,1,5,Potential Customers
16446,0,3,1.6499999999941792,4,3,1,8,Loyal Customers
16447,135,1,19.9,2,1,2,5,Potential Customers
16448,198,1,10.5,1,1,1,3,At Risk
16449,190,3,48.86,1,3,3,7,Loyal Customers
16450,149,1,40.56,1,1,3,5,Potential Customers
16451,87,1,6.72,2,1,1,4,At Risk
16454,44,3,-8.15,3,3,1,7,Returned/Churned
16455,63,7,129.9,2,4,4,10,Champions
16456,99,5,74.05000000000001,2,3,3,8,Loyal Customers
16457,218,1,35.7,1,1,2,4,At Risk
16458,2,18,350.18,4,4,4,12,Champions
16460,28,3,24.83,3,3,2,8,Loyal Customers
16461,177,1,9.95,1,1,1,3,At Risk
16462,64,4,102.0,2,3,3,8,Loyal Customers
16463,21,7,28.78000000000001,3,4,2,9,Loyal Customers
16464,19,3,15.200000000000001,3,3,2,8,Loyal Customers
16466,33,7,67.17999999999999,3,4,3,10,Champions
16468,74,1,62.400000000000006,2,1,3,6,Potential Customers
16469,23,4,4.28,3,3,1,7,Loyal Customers
16470,51,5,3.5199999999999996,2,3,1,6,Potential Customers
16471,274,1,15.8,1,1,2,4,At Risk
16473,164,4,45.75,1,3,3,7,Loyal Customers
16474,7,11,33.970000000000006,4,4,2,10,Champions
16475,88,4,159.3,2,3,4,9,Loyal Customers
16477,63,7,137.35000000000002,2,4,4,10,Champions
16478,25,3,77.7,3,3,3,9,Loyal Customers
16479,10,2,40.6,4,2,3,9,Loyal Customers
16480,75,1,10.5,2,1,1,4,At Risk
16482,15,1,6.959999999999999,4,1,1,6,Potential Customers
16483,192,1,14.95,1,1,1,3,At Risk
16484,173,3,1.7999999999999972,1,3,1,5,Potential Customers
16485,77,1,7.5,2,1,1,4,At Risk
16488,33,4,104.65,3,3,3,9,Loyal Customers
16491,46,1,20.28,3,1,2,6,Potential Customers
16493,72,6,62.849999999999994,2,4,3,9,Loyal Customers
16494,296,1,40.56,1,1,3,5,Potential Customers
16495,3,3,11.549999999999999,4,3,1,8,Loyal Customers
16496,8,4,31.07,4,3,2,9,Loyal Customers
16497,49,6,149.67000000000002,3,4,4,11,Champions
16498,161,3,-0.7500000000000018,1,3,1,5,Returned/Churned
16499,360,5,-3.8499999999999988,1,3,1,5,Returned/Churned
16500,4,6,282.66,4,4,4,12,Champions
16503,106,5,80.75,2,3,3,8,Loyal Customers
16504,25,1,1.56,3,1,1,5,Potential Customers
16505,31,1,358.56000000000006,3,1,4,8,Loyal Customers
16506,19,2,70.5,3,2,3,8,Loyal Customers
16509,296,1,76.5,1,1,3,5,Potential Customers
16510,372,1,19.9,1,1,2,4,At Risk
16511,21,3,7.35,3,3,1,7,Loyal Customers
16513,4,4,241.2,4,3,4,11,Champions
16515,52,5,61.449999999999996,2,3,3,8,Loyal Customers
16516,30,1,17.4,3,1,2,6,Potential Customers
16517,277,1,14.75,1,1,1,3,At Risk
16518,61,3,19.25,2,3,2,7,Loyal Customers
16519,25,2,17.4,3,2,2,7,Loyal Customers
16520,186,4,10.3,1,3,1,5,Potential Customers
16523,1,28,547.62,4,4,4,12,Champions
16525,2,29,1974.5400000000002,4,4,4,12,Champions
16526,171,1,13.52,1,1,1,3,At Risk
16527,81,1,8.25,2,1,1,4,At Risk
16528,3,1,9.48,4,1,1,6,Potential Customers
16529,190,1,5.95,1,1,1,3,At Risk
16531,22,7,142.07999999999998,3,4,4,11,Champions
16532,17,3,4516.8,3,3,4,10,Champions
16533,19,5,3.830000000000001,3,3,1,7,Loyal Customers
16535,5,1,15.0,4,1,1,6,Potential Customers
16536,107,2,-1.629999999999999,2,2,1,5,Returned/Churned
16539,2,4,221.1,4,3,4,11,Champions
16542,53,1,53.1,2,1,3,6,Potential Customers
16545,164,1,25.200000000000003,1,1,2,4,At Risk
16546,290,3,30.000000000000007,1,3,2,6,Potential Customers
16549,10,10,30.279999999999998,4,4,2,10,Champions
16550,108,9,83.64999999999999,2,4,3,9,Loyal Customers
16551,95,3,53.64,2,3,3,8,Loyal Customers
16552,242,2,44.74,1,2,3,6,Potential Customers
16553,163,14,1020.6100000000001,1,4,4,9,Loyal Customers
16554,3,7,-19.950000000000003,4,4,1,9,Returned/Churned
16555,35,2,36.8,3,2,2,7,Loyal Customers
16556,66,7,96.48,2,4,3,9,Loyal Customers
16557,24,2,42.5,3,2,3,8,Loyal Customers
16558,0,24,378.66,4,4,4,12,Champions
16560,21,3,4.949999999999999,3,3,1,7,Loyal Customers
16561,5,2,35.1,4,2,2,8,Loyal Customers
16563,53,1,15.0,2,1,1,4,At Risk
16565,364,1,17.85,1,1,2,4,At Risk
16566,15,6,298.40999999999997,4,4,4,12,Champions
16567,194,2,32.85,1,2,2,5,Potential Customers
16569,3,1,45.0,4,1,3,8,Loyal Customers
16570,8,15,155.36,4,4,4,12,Champions
16571,3,5,54.75,4,3,3,10,Champions
16572,127,4,28.35,2,3,2,7,Loyal Customers
16573,73,4,31.1,2,3,2,7,Loyal Customers
16574,71,1,15.0,2,1,1,4,At Risk
16579,365,1,-30.599999999999998,1,1,1,3,Returned/Churned
16581,155,2,-7.5000000000000036,1,2,1,4,Returned/Churned
16582,113,1,162.72,2,1,4,7,Loyal Customers
16583,373,1,15.0,1,1,1,3,At Risk
16584,80,3,113.15,2,3,4,9,Loyal Customers
16586,248,1,18.0,1,1,2,4,At Risk
16587,232,1,15.0,1,1,1,3,At Risk
16589,71,3,43.85,2,3,3,8,Loyal Customers
16591,68,1,3.4,2,1,1,4,At Risk
16592,4,19,245.07999999999998,4,4,4,12,Champions
16593,50,3,81.19999999999999,3,3,3,9,Loyal Customers
16594,75,1,1.25,2,1,1,4,At Risk
16595,61,1,10.5,2,1,1,4,At Risk
16596,15,2,40.050000000000004,4,2,3,9,Loyal Customers
16597,4,1,20.52,4,1,2,7,Loyal Customers
16598,277,2,5.549999999999999,1,2,1,4,At Risk
16600,4,6,88.9,4,4,3,11,Champions
16601,40,1,17.4,3,1,2,6,Potential Customers
16602,31,2,-4.800000000000001,3,2,1,6,Returned/Churned
16603,74,2,19.6,2,2,2,6,Potential Customers
16607,17,16,261.49,3,4,4,11,Champions
16609,15,9,136.81,4,4,4,12,Champions
16610,219,1,17.700000000000003,1,1,2,4,At Risk
16611,186,2,-3.46,1,2,1,4,Returned/Churned
16612,32,4,59.06,3,3,3,9,Loyal Customers
16613,70,1,16.6,2,1,2,5,Potential Customers
16614,182,1,15.600000000000001,1,1,2,4,At Risk
16616,15,2,25.08,4,2,2,8,Loyal Customers
16617,235,1,53.1,1,1,3,5,Potential Customers
16618,31,6,96.66,3,4,3,10,Champions
16619,253,2,1.4999999999999982,1,2,1,4,At Risk
16620,3,2,40.3,4,2,3,9,Loyal Customers
16621,51,4,78.1,2,3,3,8,Loyal Customers
16623,245,1,8.850000000000001,1,1,1,3,At Risk
16624,80,2,21.15,2,2,2,6,Potential Customers
16625,274,1,8.5,1,1,1,3,At Risk
16626,0,20,846.12,4,4,4,12,Champions
16627,79,1,18.72,2,1,2,5,Potential Customers
16628,29,6,186.24,3,4,4,11,Champions
16629,73,2,7.56,2,2,1,5,Potential Customers
16633,17,7,156.2,3,4,4,11,Champions
16634,222,2,83.1,1,2,3,6,Potential Customers
16637,32,5,64.02000000000001,3,3,3,9,Loyal Customers
16638,22,11,200.51,3,4,4,11,Champions
16639,25,4,59.669999999999995,3,3,3,9,Loyal Customers
16641,105,1,17.700000000000003,2,1,2,5,Potential Customers
16642,4,3,72.9,4,3,3,10,Champions
16643,245,1,27.0,1,1,2,4,At Risk
16644,177,2,24.14,1,2,2,5,Potential Customers
16647,169,2,22.439999999999998,1,2,2,5,Potential Customers
16648,38,2,-1.5,3,2,1,6,Returned/Churned
16650,71,1,5.04,2,1,1,4,At Risk
16652,53,11,363.77000000000004,2,4,4,10,Champions
16653,16,3,73.91,4,3,3,10,Champions
16654,141,5,98.05000000000001,2,3,3,8,Loyal Customers
16655,17,6,395.92,3,4,4,11,Champions
16656,22,21,1677.31,3,4,4,11,Champions
16657,9,4,40.59,4,3,3,10,Champions
16658,368,1,5.04,1,1,1,3,At Risk
16659,189,1,20.4,1,1,2,4,At Risk
16660,16,5,136.15999999999997,4,3,4,11,Champions
16665,362,1,25.5,1,1,2,4,At Risk
16666,19,1,1.9500000000000002,3,1,1,5,Potential Customers
16667,68,2,29.1,2,2,2,6,Potential Customers
16668,15,6,79.97999999999999,4,4,3,11,Champions
16669,23,4,45.15,3,3,3,9,Loyal Customers
16670,16,17,120.72,4,4,4,12,Champions
16671,28,3,1050.39,3,3,4,10,Champions
16672,2,23,1399.13,4,4,4,12,Champions
16674,54,2,9.7,2,2,1,5,Potential Customers
16676,33,5,50.68,3,3,3,9,Loyal Customers
16678,2,17,211.45,4,4,4,12,Champions
16679,366,1,102.0,1,1,3,5,Potential Customers
16680,43,1,16.5,3,1,2,6,Potential Customers
16681,72,6,417.96000000000004,2,4,4,10,Champions
16682,4,5,230.35999999999999,4,3,4,11,Champions
16684,4,31,7188.2,4,4,4,12,Champions
16685,61,2,10.75,2,2,1,5,Potential Customers
16686,47,9,39.95,3,4,3,10,Champions
16688,1,4,68.84,4,3,3,10,Champions
16689,75,3,63.339999999999996,2,3,3,8,Loyal Customers
16690,43,3,50.25,3,3,3,9,Loyal Customers
16692,256,2,158.5,1,2,4,7,Loyal Customers
16693,68,2,31.3,2,2,2,6,Potential Customers
16696,135,4,301.5,2,3,4,9,Loyal Customers
16697,241,1,0.95,1,1,1,3,At Risk
16698,226,2,1020.0,1,2,4,7,Loyal Customers
16700,8,17,255.48000000000002,4,4,4,12,Champions
16701,8,18,621.95,4,4,4,12,Champions
16705,0,29,1321.21,4,4,4,12,Champions
16706,37,3,33.3,3,3,2,8,Loyal Customers
16708,45,1,19.8,3,1,2,6,Potential Customers
16709,84,5,175.2,2,3,4,9,Loyal Customers
16710,19,10,105.33,3,4,3,10,Champions
16711,3,5,617.5200000000001,4,3,4,11,Champions
16712,9,11,379.94000000000005,4,4,4,12,Champions
16713,18,21,287.18,3,4,4,11,Champions
16714,218,4,-222.5,1,3,1,5,Returned/Churned
16715,78,1,6.959999999999999,2,1,1,4,At Risk
16716,266,3,319.8000000000001,1,3,4,8,Loyal Customers
16717,9,9,163.87,4,4,4,12,Champions
16718,369,1,15.0,1,1,1,3,At Risk
16719,14,8,56.45,4,4,3,11,Champions
16720,26,1,2.25,3,1,1,5,Potential Customers
16721,262,1,2.6,1,1,1,3,At Risk
16722,17,16,337.95,3,4,4,11,Champions
16723,91,2,177.75,2,2,4,8,Loyal Customers
16725,302,8,39.5,1,4,2,7,Loyal Customers
16726,26,5,90.6,3,3,3,9,Loyal Customers
16727,364,1,16.5,1,1,2,4,At Risk
16728,46,4,64.86999999999999,3,3,3,9,Loyal Customers
16729,36,26,147.82000000000002,3,4,4,11,Champions
16730,52,4,15.609999999999998,2,3,2,7,Loyal Customers
16732,31,1,64.19999999999999,3,1,3,7,Loyal Customers
16734,52,3,19.6,2,3,2,7,Loyal Customers
16735,78,7,84.52,2,4,3,9,Loyal Customers
16737,53,1,417.59999999999997,2,1,4,7,Loyal Customers
16738,297,1,3.75,1,1,1,3,At Risk
16739,172,2,14.849999999999998,1,2,1,4,At Risk
16742,46,2,457.4,3,2,4,9,Loyal Customers
16743,29,8,53.83,3,4,3,10,Champions
16744,11,7,15.6,4,4,2,10,Champions
16745,86,18,533.43,2,4,4,10,Champions
16746,4,19,306.16,4,4,4,12,Champions
16747,25,4,29.79,3,3,2,8,Loyal Customers
16748,17,5,136.1,3,3,4,10,Champions
16750,44,5,26.09,3,3,2,8,Loyal Customers
16751,30,1,918.0,3,1,4,8,Loyal Customers
16752,372,1,12.600000000000001,1,1,1,3,At Risk
16753,58,1,0.75,2,1,1,4,At Risk
16754,372,1,518.4,1,1,4,6,Potential Customers
16755,114,5,32.4,2,3,2,7,Loyal Customers
16756,214,1,15.0,1,1,1,3,At Risk
16757,318,1,5.04,1,1,1,3,At Risk
16758,65,1,16.4,2,1,2,5,Potential Customers
16759,7,4,35.05,4,3,2,9,Loyal Customers
16761,96,1,46.800000000000004,2,1,3,6,Potential Customers
16762,19,3,94.95000000000002,3,3,3,9,Loyal Customers
16763,185,2,72.74999999999999,1,2,3,6,Potential Customers
16764,3,18,28.94,4,4,2,10,Champions
16765,294,1,34.0,1,1,2,4,At Risk
16766,273,2,54.900000000000006,1,2,3,6,Potential Customers
16767,30,11,413.43,3,4,4,11,Champions
16768,47,5,25.4,3,3,2,8,Loyal Customers
16769,260,1,5.9,1,1,1,3,At Risk
16770,57,6,27.749999999999996,2,4,2,8,Loyal Customers
16771,33,5,46.51,3,3,3,9,Loyal Customers
16773,57,1,23.400000000000002,2,1,2,5,Potential Customers
16774,67,5,42.849999999999994,2,3,3,8,Loyal Customers
16775,10,11,85.7,4,4,3,11,Champions
16776,60,1,6.5,2,1,1,4,At Risk
16777,80,2,14.11,2,2,1,5,Potential Customers
16778,74,2,23.28,2,2,2,6,Potential Customers
16779,2,28,1204.46,4,4,4,12,Champions
16780,100,2,26.25,2,2,2,6,Potential Customers
16781,365,2,30.150000000000002,1,2,2,5,Potential Customers
16782,10,19,177.3,4,4,4,12,Champions
16784,19,1,30.0,3,1,2,6,Potential Customers
16788,123,2,2.44,2,2,1,5,Potential Customers
16789,8,1,19.799999999999997,4,1,2,7,Loyal Customers
16790,3,8,93.65,4,4,3,11,Champions
16791,29,8,32.72,3,4,2,9,Loyal Customers
16792,282,2,13.7,1,2,1,4,At Risk
16793,57,1,10.2,2,1,1,4,At Risk
16794,1,12,34.2,4,4,2,10,Champions
16795,365,1,16.15,1,1,2,4,At Risk
16796,89,1,6.64,2,1,1,4,At Risk
16800,11,1,4.95,4,1,1,6,Potential Customers
16801,163,5,53.349999999999994,1,3,3,7,Loyal Customers
16803,65,1,10.0,2,1,1,4,At Risk
16804,23,3,9.66,3,3,1,7,Loyal Customers
16805,173,2,12.95,1,2,1,4,At Risk
16806,103,4,46.74,2,3,3,8,Loyal Customers
16807,142,3,49.980000000000004,2,3,3,8,Loyal Customers
16808,99,2,74.25,2,2,3,7,Loyal Customers
16809,23,6,30.89,3,4,2,9,Loyal Customers
16810,192,2,-13.099999999999998,1,2,1,4,Returned/Churned
16811,4,2,47.85,4,2,3,9,Loyal Customers
16812,360,1,87.6,1,1,3,5,Potential Customers
16813,8,10,70.07,4,4,3,11,Champions
16814,14,22,511.0,4,4,4,12,Champions
16816,103,4,69.33,2,3,3,8,Loyal Customers
16817,2,13,95.65,4,4,3,11,Champions
16818,10,13,153.15,4,4,4,12,Champions
16820,95,1,23.4,2,1,2,5,Potential Customers
16823,227,1,8.25,1,1,1,3,At Risk
16824,15,2,40.35,4,2,3,9,Loyal Customers
16825,38,2,89.28,3,2,3,8,Loyal Customers
16826,51,1,17.4,2,1,2,5,Potential Customers
16828,93,2,27.6,2,2,2,6,Potential Customers
16829,156,1,12.600000000000001,1,1,1,3,At Risk
16830,38,1,20.28,3,1,2,6,Potential Customers
16832,184,3,99.35,1,3,3,7,Loyal Customers
16833,1,4,66.6,4,3,3,10,Champions
16834,227,1,30.0,1,1,2,4,At Risk
16835,128,2,31.8,2,2,2,6,Potential Customers
16836,39,2,91.26,3,2,3,8,Loyal Customers
16837,31,12,521.43,3,4,4,11,Champions
16838,197,3,17.529999999999998,1,3,2,6,Potential Customers
16839,8,39,3511.77,4,4,4,12,Champions
16841,36,7,-3.780000000000001,3,4,1,8,Returned/Churned
16842,64,4,32.95,2,3,2,7,Loyal Customers
16843,42,17,418.03,3,4,4,11,Champions
16846,50,1,24.96,3,1,2,6,Potential Customers
16847,43,1,15.0,3,1,1,5,Potential Customers
16848,52,1,34.68,2,1,2,5,Potential Customers
16849,186,1,17.700000000000003,1,1,2,4,At Risk
16850,333,1,19.799999999999997,1,1,2,4,At Risk
16851,4,3,25.619999999999997,4,3,2,9,Loyal Customers
16852,10,2,23.6,4,2,2,8,Loyal Customers
16855,23,2,34.8,3,2,2,7,Loyal Customers
16856,14,1,17.700000000000003,4,1,2,7,Loyal Customers
16858,366,2,24.3,1,2,2,5,Potential Customers
16859,106,5,-41.870000000000005,2,3,1,6,Returned/Churned
16861,59,3,51.150000000000006,2,3,3,8,Loyal Customers
16863,29,4,4.050000000000001,3,3,1,7,Loyal Customers
16866,140,3,119.85,2,3,4,9,Loyal Customers
16869,22,5,-3.23,3,3,1,7,Returned/Churned
16871,22,7,164.9,3,4,4,11,Champions
16872,77,3,285.27,2,3,4,9,Loyal Customers
16873,4,10,100.35,4,4,3,11,Champions
16875,64,9,54.050000000000004,2,4,3,9,Loyal Customers
16877,12,6,58.19,4,4,3,11,Champions
16878,24,2,8.25,3,2,1,6,Potential Customers
16880,30,7,44.66,3,4,3,10,Champions
16881,66,1,432.0,2,1,4,7,Loyal Customers
16882,66,3,38.2,2,3,2,7,Loyal Customers
16883,187,2,22.7,1,2,2,5,Potential Customers
16884,37,2,37.7,3,2,2,7,Loyal Customers
16885,15,3,28.48,4,3,2,9,Loyal Customers
16887,35,1,6.75,3,1,1,5,Potential Customers
16889,194,3,31.560000000000002,1,3,2,6,Potential Customers
16891,1,5,44.89,4,3,3,10,Champions
16892,1,7,25.650000000000002,4,4,2,10,Champions
16893,366,1,1.65,1,1,1,3,At Risk
16895,64,1,5.0,2,1,1,4,At Risk
16897,299,3,7.25,1,3,1,5,Potential Customers
16898,26,4,-51.21999999999999,3,3,1,7,Returned/Churned
16899,7,6,63.6,4,4,3,11,Champions
16900,11,5,-639.8699999999999,4,3,1,8,Returned/Churned
16902,116,1,37.5,2,1,2,5,Potential Customers
16903,29,1,8.25,3,1,1,5,Potential Customers
16904,4,16,241.45000000000002,4,4,4,12,Champions
16905,5,8,80.2,4,4,3,11,Champions
16906,81,4,35.0,2,3,2,7,Loyal Customers
16907,29,5,28.41,3,3,2,8,Loyal Customers
16909,64,2,62.75999999999999,2,2,3,7,Loyal Customers
16910,4,8,26.46,4,4,2,10,Champions
16912,23,14,255.39,3,4,4,11,Champions
16913,290,1,39.15,1,1,2,4,At Risk
16914,36,1,9.95,3,1,1,5,Potential Customers
16915,9,6,74.85000000000001,4,4,3,11,Champions
16916,23,2,5.25,3,2,1,6,Potential Customers
16917,276,1,122.39999999999999,1,1,4,6,Potential Customers
16918,49,7,76.82000000000001,3,4,3,10,Champions
16919,156,11,232.20000000000002,1,4,4,9,Loyal Customers
16921,61,1,1.68,2,1,1,4,At Risk
16923,12,26,228.5,4,4,4,12,Champions
16924,21,4,-4.390000000000001,3,3,1,7,Returned/Churned
16926,371,1,8.7,1,1,1,3,At Risk
16927,115,3,285.6,2,3,4,9,Loyal Customers
16928,80,19,187.74,2,4,4,10,Champions
16929,3,7,126.78,4,4,4,12,Champions
16930,26,3,15.100000000000001,3,3,2,8,Loyal Customers
16931,5,21,87.74000000000001,4,4,3,11,Champions
16932,53,1,8.25,2,1,1,4,At Risk
16933,1,5,45.970000000000006,4,3,3,10,Champions
16934,54,2,32.150000000000006,2,2,2,6,Potential Customers
16936,25,1,9.899999999999999,3,1,1,5,Potential Customers
16938,8,5,-788.4000000000001,4,3,1,8,Returned/Churned
16940,52,3,30.45,2,3,2,7,Loyal Customers
16942,12,10,48.760000000000005,4,4,3,11,Champions
16943,211,3,125.8,1,3,4,8,Loyal Customers
16945,21,19,313.21000000000004,3,4,4,11,Champions
16947,235,1,27.04,1,1,2,4,At Risk
16948,138,3,75.0,2,3,3,8,Loyal Customers
16949,3,7,28.420000000000005,4,4,2,10,Champions
16950,56,3,172.8,2,3,4,9,Loyal Customers
16951,123,4,30.200000000000003,2,3,2,7,Loyal Customers
16952,109,2,12.19,2,2,1,5,Potential Customers
16953,30,1,20.8,3,1,2,6,Potential Customers
16954,0,9,750.75,4,4,4,12,Champions
16955,184,5,66.95,1,3,3,7,Loyal Customers
16956,9,2,16.400000000000002,4,2,2,8,Loyal Customers
16957,239,2,102.6,1,2,3,6,Potential Customers
16959,87,1,12.75,2,1,1,4,At Risk
16960,38,3,4.88,3,3,1,7,Loyal Customers
16961,116,1,20.0,2,1,2,5,Potential Customers
16963,187,1,15.0,1,1,1,3,At Risk
16965,226,1,9.120000000000001,1,1,1,3,At Risk
16966,8,10,427.90999999999997,4,4,4,12,Champions
16967,189,1,15.0,1,1,1,3,At Risk
16968,4,2,30.450000000000003,4,2,2,8,Loyal Customers
16969,39,3,79.32000000000001,3,3,3,9,Loyal Customers
16971,2,2,0.0,4,2,1,7,Returned/Churned
16976,267,1,76.32000000000001,1,1,3,5,Potential Customers
16978,77,1,8.5,2,1,1,4,At Risk
16979,3,8,72.07,4,4,3,11,Champions
16980,255,2,19.349999999999998,1,2,2,5,Potential Customers
16982,60,1,17.0,2,1,2,5,Potential Customers
16983,12,8,120.53,4,4,4,12,Champions
16984,78,5,-16.3,2,3,1,6,Returned/Churned
16985,17,11,482.34,3,4,4,11,Champions
16986,29,2,1810.8,3,2,4,9,Loyal Customers
16987,3,7,64.22,4,4,3,11,Champions
16988,5,1,19.799999999999997,4,1,2,7,Loyal Customers
16989,7,6,405.54999999999995,4,4,4,12,Champions
16990,218,1,179.0,1,1,4,6,Potential Customers
16992,10,6,104.14999999999999,4,4,3,11,Champions
16995,372,1,-1.25,1,1,1,3,Returned/Churned
16996,30,9,260.14,3,4,4,11,Champions
16997,288,3,156.0,1,3,4,8,Loyal Customers
16998,149,6,287.02000000000004,1,4,4,9,Loyal Customers
16999,23,2,29.75,3,2,2,7,Loyal Customers
17001,0,11,229.9,4,4,4,12,Champions
17002,73,4,129.25,2,3,4,9,Loyal Customers
17004,46,2,42.05,3,2,3,8,Loyal Customers
17006,4,4,91.28,4,3,3,10,Champions
17007,50,7,80.42,3,4,3,10,Champions
17010,16,2,0.29999999999999893,4,2,1,7,Loyal Customers
17011,30,1,19.8,3,1,2,6,Potential Customers
17014,8,4,59.7,4,3,3,10,Champions
17015,28,3,43.5,3,3,3,9,Loyal Customers
17017,2,27,852.51,4,4,4,12,Champions
17018,40,2,92.7,3,2,3,8,Loyal Customers
17019,11,4,24.9,4,3,2,9,Loyal Customers
17022,31,1,20.8,3,1,2,6,Potential Customers
17024,45,3,95.85,3,3,3,9,Loyal Customers
17025,60,3,58.25,2,3,3,8,Loyal Customers
17026,185,2,134.43,1,2,4,7,Loyal Customers
17027,78,7,30.75,2,4,2,8,Loyal Customers
17029,110,2,716.0,2,2,4,8,Loyal Customers
17030,63,1,2.9,2,1,1,4,At Risk
17031,11,2,83.2,4,2,3,9,Loyal Customers
17033,86,3,221.75999999999996,2,3,4,9,Loyal Customers
17034,16,4,16.229999999999997,4,3,2,9,Loyal Customers
17035,245,3,42.919999999999995,1,3,3,7,Loyal Customers
17037,78,2,13.049999999999999,2,2,1,5,Potential Customers
17038,30,1,5.95,3,1,1,5,Potential Customers
17040,137,1,175.2,2,1,4,7,Loyal Customers
17041,26,4,20.799999999999997,3,3,2,8,Loyal Customers
17042,2,5,88.8,4,3,3,10,Champions
17043,32,4,148.2,3,3,4,10,Champions
17044,8,3,82.51,4,3,3,10,Champions
17045,113,3,56.46,2,3,3,8,Loyal Customers
17046,157,1,30.0,1,1,2,4,At Risk
17047,85,3,55.260000000000005,2,3,3,8,Loyal Customers
17048,115,6,19.4,2,4,2,8,Loyal Customers
17049,2,11,225.93,4,4,4,12,Champions
17050,96,6,71.4,2,4,3,9,Loyal Customers
17051,194,1,2.5,1,1,1,3,At Risk
17052,28,1,11.8,3,1,1,5,Potential Customers
17053,128,2,33.300000000000004,2,2,2,6,Potential Customers
17054,28,6,86.72999999999999,3,4,3,10,Champions
17058,81,3,58.400000000000006,2,3,3,8,Loyal Customers
17059,29,5,57.89,3,3,3,9,Loyal Customers
17060,266,1,17.700000000000003,1,1,2,4,At Risk
17061,73,12,670.48,2,4,4,10,Champions
17062,313,5,14.920000000000002,1,3,1,5,Potential Customers
17063,8,11,135.05,4,4,4,12,Champions
17064,58,3,104.8,2,3,3,8,Loyal Customers
17065,143,1,-112.35,2,1,1,4,Returned/Churned
17068,12,22,445.2,4,4,4,12,Champions
17069,28,13,123.63000000000001,3,4,4,11,Champions
17070,114,1,3.95,2,1,1,4,At Risk
17071,8,14,213.45,4,4,4,12,Champions
17073,17,4,23.02,3,3,2,8,Loyal Customers
17075,17,5,14.47,3,3,1,7,Loyal Customers
17076,36,3,93.9,3,3,3,9,Loyal Customers
17078,36,2,69.0,3,2,3,8,Loyal Customers
17079,78,1,59.400000000000006,2,1,3,6,Potential Customers
17080,22,3,140.2,3,3,4,10,Champions
17081,25,2,6.37,3,2,1,6,Potential Customers
17082,33,2,46.160000000000004,3,2,3,8,Loyal Customers
17083,109,3,93.4,2,3,3,8,Loyal Customers
17084,35,2,38.4,3,2,2,7,Loyal Customers
17085,123,6,28.86,2,4,2,8,Loyal Customers
17086,7,6,214.89999999999998,4,4,4,12,Champions
17088,28,4,77.22,3,3,3,9,Loyal Customers
17090,4,8,543.6700000000001,4,4,4,12,Champions
17091,2,10,128.84,4,4,4,12,Champions
17092,50,4,48.230000000000004,3,3,3,9,Loyal Customers
17094,318,2,-23.3,1,2,1,4,Returned/Churned
17095,22,6,-199.05,3,4,1,8,Returned/Churned
17096,9,7,56.940000000000005,4,4,3,11,Champions
17097,2,9,60.76,4,4,3,11,Champions
17100,18,2,29.85,3,2,2,7,Loyal Customers
17101,10,4,256.0,4,3,4,11,Champions
17102,261,1,25.5,1,1,2,4,At Risk
17105,159,2,14.3,1,2,1,4,At Risk
17107,32,7,400.09999999999997,3,4,4,11,Champions
17109,29,8,33.04,3,4,2,9,Loyal Customers
17110,165,1,16.5,1,1,2,4,At Risk
17111,47,1,15.0,3,1,1,5,Potential Customers
17114,5,10,55.449999999999996,4,4,3,11,Champions
17115,8,5,37.9,4,3,2,9,Loyal Customers
17117,288,1,17.0,1,1,2,4,At Risk
17118,317,1,16.5,1,1,2,4,At Risk
17119,3,3,21.05,4,3,2,9,Loyal Customers
17120,233,1,16.5,1,1,2,4,At Risk
17122,119,1,19.799999999999997,2,1,2,5,Potential Customers
17123,161,1,25.200000000000003,1,1,2,4,At Risk
17124,185,1,15.9,1,1,2,4,At Risk
17125,50,1,15.0,3,1,1,5,Potential Customers
17126,152,7,1.0600000000000007,1,4,1,6,Potential Customers
17128,334,1,5.9,1,1,1,3,At Risk
17131,5,5,86.8,4,3,3,10,Champions
17133,15,7,1174.7,4,4,4,12,Champions
17134,106,2,35.45,2,2,2,6,Potential Customers
17135,16,7,275.06,4,4,4,12,Champions
17138,275,1,17.9,1,1,2,4,At Risk
17139,15,15,332.91999999999996,4,4,4,12,Champions
17140,247,1,7.5,1,1,1,3,At Risk
17142,239,1,35.849999999999994,1,1,2,4,At Risk
17144,1,2,30.6,4,2,2,8,Loyal Customers
17146,105,3,202.55,2,3,4,9,Loyal Customers
17147,22,6,65.02,3,4,3,10,Champions
17148,51,1,8.5,2,1,1,4,At Risk
17152,194,4,102.55000000000001,1,3,3,7,Loyal Customers
17153,24,1,17.85,3,1,2,6,Potential Customers
17154,75,1,24.96,2,1,2,5,Potential Customers
17155,17,2,74.0,3,2,3,8,Loyal Customers
17157,7,3,33.05,4,3,2,9,Loyal Customers
17158,32,3,72.75,3,3,3,9,Loyal Customers
17159,21,4,76.1,3,3,3,9,Loyal Customers
17160,31,6,92.96000000000001,3,4,3,10,Champions
17162,28,11,124.25,3,4,4,11,Champions
17163,21,2,131.7,3,2,4,9,Loyal Customers
17164,32,8,127.51,3,4,4,11,Champions
17165,284,1,19.9,1,1,2,4,At Risk
17166,38,3,30.400000000000002,3,3,2,8,Loyal Customers
17169,50,4,23.700000000000003,3,3,2,8,Loyal Customers
17171,289,1,5.04,1,1,1,3,At Risk
17172,74,2,9.419999999999998,2,2,1,5,Potential Customers
17173,5,9,509.85,4,4,4,12,Champions
17174,217,1,19.5,1,1,2,4,At Risk
17175,44,5,124.9,3,3,4,10,Champions
17176,201,1,10.2,1,1,1,3,At Risk
17179,178,3,18.52,1,3,2,6,Potential Customers
17180,56,6,-3.220000000000001,2,4,1,7,Returned/Churned
17181,57,2,77.97000000000001,2,2,3,7,Loyal Customers
17183,7,8,388.58000000000004,4,4,4,12,Champions
17186,46,2,144.0,3,2,4,9,Loyal Customers
17187,226,1,30.599999999999998,1,1,2,4,At Risk
17188,11,9,137.46999999999997,4,4,4,12,Champions
17189,106,2,6.6899999999999995,2,2,1,5,Potential Customers
17190,58,3,10.4,2,3,1,6,Potential Customers
17191,28,7,83.05000000000001,3,4,3,10,Champions
17193,35,9,406.12,3,4,4,11,Champions
17194,273,2,11.65,1,2,1,4,At Risk
17197,29,1,30.0,3,1,2,6,Potential Customers
17198,23,3,7.710000000000001,3,3,1,7,Loyal Customers
17201,53,1,0.65,2,1,1,4,At Risk
17203,35,6,112.66000000000001,3,4,4,11,Champions
17204,169,9,68.60999999999999,1,4,3,8,Loyal Customers
17205,53,1,15.12,2,1,2,5,Potential Customers
17206,53,1,34.68,2,1,2,5,Potential Customers
17211,26,9,117.1,3,4,4,11,Champions
17212,253,1,3.95,1,1,1,3,At Risk
17213,40,11,138.27,3,4,4,11,Champions
17214,60,7,46.59999999999999,2,4,3,9,Loyal Customers
17217,234,1,11.8,1,1,1,3,At Risk
17218,4,10,39.48,4,4,2,10,Champions
17219,31,1,5.0,3,1,1,5,Potential Customers
17220,24,14,142.38,3,4,4,11,Champions
17221,7,2,10.8,4,2,1,7,Loyal Customers
17222,65,1,7.5,2,1,1,4,At Risk
17223,310,2,60.5,1,2,3,6,Potential Customers
17226,308,1,3.3600000000000003,1,1,1,3,At Risk
17227,18,6,44.24,3,4,3,10,Champions
17228,15,8,91.27,4,4,3,11,Champions
17229,96,2,4.15,2,2,1,5,Potential Customers
17230,264,11,168.28,1,4,4,9,Loyal Customers
17231,12,14,31.450000000000003,4,4,2,10,Champions
17232,2,2,39.3,4,2,2,8,Loyal Customers
17233,35,1,23.4,3,1,2,6,Potential Customers
17234,182,1,4.95,1,1,1,3,At Risk
17235,25,2,56.25,3,2,3,8,Loyal Customers
17236,12,6,80.85,4,4,3,11,Champions
17237,11,2,7.93,4,2,1,7,Loyal Customers
17238,2,17,93.44,4,4,3,11,Champions
17239,312,2,4.050000000000001,1,2,1,4,At Risk
17242,108,2,99.60000000000001,2,2,3,7,Loyal Customers
17243,1,30,571.9,4,4,4,12,Champions
17244,53,1,51.0,2,1,3,6,Potential Customers
17245,204,1,15.299999999999999,1,1,2,4,At Risk
17247,15,1,2.08,4,1,1,6,Potential Customers
17248,120,1,4.95,2,1,1,4,At Risk
17250,3,2,24.299999999999997,4,2,2,8,Loyal Customers
17251,362,1,4.25,1,1,1,3,At Risk
17252,116,2,13.35,2,2,1,5,Potential Customers
17253,18,1,14.56,3,1,1,5,Potential Customers
17254,4,2,1.34,4,2,1,7,Loyal Customers
17255,40,2,9.64,3,2,1,6,Potential Customers
17256,107,2,140.4,2,2,4,8,Loyal Customers
17259,148,2,10.030000000000001,1,2,1,4,At Risk
17262,52,5,731.9100000000001,2,3,4,9,Loyal Customers
17263,208,1,0.95,1,1,1,3,At Risk
17265,138,2,7.88,2,2,1,5,Potential Customers
17266,2,3,8.2,4,3,1,8,Loyal Customers
17267,127,2,26.4,2,2,2,6,Potential Customers
17268,107,4,449.12,2,3,4,9,Loyal Customers
17272,42,5,85.55,3,3,3,9,Loyal Customers
17274,35,1,0.83,3,1,1,5,Potential Customers
17277,227,2,25.799999999999997,1,2,2,5,Potential Customers
17278,241,1,25.5,1,1,2,4,At Risk
17279,57,1,51.0,2,1,3,6,Potential Customers
17282,130,3,460.02000000000004,2,3,4,9,Loyal Customers
17284,60,7,27.66,2,4,2,8,Loyal Customers
17286,21,1,8.5,3,1,1,5,Potential Customers
17287,26,7,50.730000000000004,3,4,3,10,Champions
17288,9,7,158.73,4,4,4,12,Champions
17289,31,4,10.51,3,3,1,7,Loyal Customers
17290,3,2,7.36,4,2,1,7,Loyal Customers
17291,308,1,550.8000000000001,1,1,4,6,Potential Customers
17293,8,9,211.73,4,4,4,12,Champions
17295,28,3,41.4,3,3,3,9,Loyal Customers
17297,17,1,9.95,3,1,1,5,Potential Customers
17298,101,2,37.83,2,2,2,6,Potential Customers
17299,11,4,68.03999999999999,4,3,3,10,Champions
17301,21,1,4.15,3,1,1,5,Potential Customers
17302,14,6,44.75000000000001,4,4,3,11,Champions
17303,361,1,1.45,1,1,1,3,At Risk
17306,10,21,2589.85,4,4,4,12,Champions
17307,365,1,-152.64000000000001,1,2,1,4,Returned/Churned
17309,95,1,4.949999999999999,2,2,1,5,Potential Customers
17311,78,2,49.9,2,2,3,7,Loyal Customers
17312,138,3,267.75,2,3,4,9,Loyal Customers
17313,17,2,88.74,3,2,3,8,Loyal Customers
17314,24,11,161.94,3,4,4,11,Champions
17315,0,43,1012.64,4,4,4,12,Champions
17317,46,5,615.6,3,3,4,10,Champions
17320,100,3,67.6,2,3,3,8,Loyal Customers
17321,8,2,45.4,4,2,3,9,Loyal Customers
17323,15,9,20.93,4,4,2,10,Champions
17324,17,4,36.45,3,3,2,8,Loyal Customers
17325,280,1,11.7,1,2,1,4,At Risk
17329,14,2,13.850000000000001,4,2,1,7,Loyal Customers
17330,22,2,158.4,3,2,4,9,Loyal Customers
17331,123,1,175.2,2,2,4,8,Loyal Customers
17333,85,1,39.599999999999994,2,2,3,7,Loyal Customers
17334,301,3,49.67999999999999,1,3,3,7,Loyal Customers
17337,151,7,-11.980000000000006,1,4,1,6,Returned/Churned
17338,17,10,77.0,3,4,3,10,Champions
17339,94,2,97.80000000000001,2,2,3,7,Loyal Customers
17340,9,16,15.710000000000015,4,4,2,10,Champions
17341,156,3,29.5,1,3,2,6,Potential Customers
17343,355,1,35.7,1,2,2,5,Potential Customers
17344,46,1,5.95,3,2,1,6,Potential Customers
17345,15,4,48.63,4,3,3,10,Champions
17346,3,16,49.059999999999995,4,4,3,11,Champions
17347,86,1,228.96,2,2,4,8,Loyal Customers
17348,14,5,52.37,4,3,3,10,Champions
17349,179,1,12.75,1,2,1,4,At Risk
17350,8,5,25.26,4,3,2,9,Loyal Customers
17351,36,3,53.550000000000004,3,3,3,9,Loyal Customers
17353,129,2,435.0,2,2,4,8,Loyal Customers
17354,50,1,14.25,3,2,1,6,Potential Customers
17356,311,1,28.049999999999997,1,2,2,5,Potential Customers
17357,24,2,75.26,3,2,3,8,Loyal Customers
17358,303,2,17.1,1,2,2,5,Potential Customers
17359,11,1,1.25,4,2,1,7,Loyal Customers
17360,17,3,16.28,3,3,2,8,Loyal Customers
17361,49,3,49.17,3,3,3,9,Loyal Customers
17362,239,2,12.2,1,2,1,4,At Risk
17364,0,12,227.76,4,4,4,12,Champions
17365,12,8,62.5,4,4,3,11,Champions
17367,238,1,17.4,1,2,2,5,Potential Customers
17368,23,9,368.86999999999995,3,4,4,11,Champions
17370,72,4,69.96,2,3,3,8,Loyal Customers
17371,17,3,4.22,3,3,1,7,Loyal Customers
17372,40,8,67.25,3,4,3,10,Champions
17373,40,4,75.38,3,3,3,9,Loyal Customers
17374,218,2,30.9,1,2,2,5,Potential Customers
17375,190,4,0.75,1,3,1,5,Potential Customers
17376,70,2,12.399999999999999,2,2,1,5,Potential Customers
17377,23,21,17.160000000000007,3,4,2,9,Loyal Customers
17379,11,1,2.08,4,2,1,7,Loyal Customers
17381,8,30,5728.5,4,4,4,12,Champions
17382,65,1,50.400000000000006,2,2,3,7,Loyal Customers
17383,4,1,2.95,4,2,1,7,Loyal Customers
17384,19,2,17.85,3,2,2,7,Loyal Customers
17385,14,1,15.0,4,2,1,7,Loyal Customers
17386,7,6,439.86000000000007,4,4,4,12,Champions
17387,19,2,50.400000000000006,3,2,3,8,Loyal Customers
17388,77,4,777.2,2,3,4,9,Loyal Customers
17389,0,43,4464.99,4,4,4,12,Champions
17391,163,2,305.28000000000003,1,2,4,7,Loyal Customers
17392,306,2,3.5999999999999996,1,2,1,4,At Risk
17394,219,1,9.95,1,2,1,4,At Risk
17396,39,8,1833.65,3,4,4,11,Champions
17397,22,2,13.850000000000001,3,2,1,6,Potential Customers
17398,114,3,72.3,2,3,3,8,Loyal Customers
17400,126,5,40.67,2,3,3,8,Loyal Customers
17402,4,13,1039.52,4,4,4,12,Champions
17403,36,1,15.0,3,2,1,6,Potential Customers
17404,4,18,1801.88,4,4,4,12,Champions
17405,1,5,17.46,4,3,2,9,Loyal Customers
17406,330,5,7.4500000000000055,1,3,1,5,Potential Customers
17408,163,1,12.75,1,2,1,4,At Risk
17409,184,2,77.65,1,2,3,6,Potential Customers
17410,16,5,86.7,4,3,3,10,Champions
17411,12,4,32.42,4,3,2,9,Loyal Customers
17412,2,7,129.76,4,4,4,12,Champions
17414,43,2,194.4,3,2,4,9,Loyal Customers
17415,79,1,170.0,2,2,4,8,Loyal Customers
17416,29,9,433.41,3,4,4,11,Champions
17418,42,2,28.160000000000004,3,2,2,7,Loyal Customers
17419,11,14,204.27,4,4,4,12,Champions
17420,50,3,60.65,3,3,3,9,Loyal Customers
17422,16,10,110.35,4,4,4,12,Champions
17423,45,4,5.32,3,3,1,7,Loyal Customers
17425,19,2,87.2,3,2,3,8,Loyal Customers
17426,4,7,115.2,4,4,4,12,Champions
17427,71,1,30.0,2,2,2,6,Potential Customers
17428,0,33,1951.0900000000001,4,4,4,12,Champions
17429,120,4,30.57,2,3,2,7,Loyal Customers
17430,32,2,25.8,3,2,2,7,Loyal Customers
17431,313,1,5.8500000000000005,1,2,1,4,At Risk
17432,18,2,9.65,3,2,1,6,Potential Customers
17433,88,1,0.85,2,2,1,5,Potential Customers
17434,2,9,153.77,4,4,4,12,Champions
17436,1,2,63.3,4,2,3,9,Loyal Customers
17438,247,2,21.25,1,2,2,5,Potential Customers
17440,147,5,135.15,1,3,4,8,Loyal Customers
17442,29,10,81.55,3,4,3,10,Champions
17443,219,1,534.24,1,2,4,7,Loyal Customers
17444,147,3,587.5400000000001,1,3,4,8,Loyal Customers
17446,176,2,26.400000000000002,1,2,2,5,Potential Customers
17447,40,2,40.26,3,2,3,8,Loyal Customers
17448,144,1,-4287.63,1,2,1,4,Returned/Churned
17449,2,8,58.36,4,4,3,11,Champions
17450,8,55,20062.47,4,4,4,12,Champions
17451,1,10,94.9,4,4,3,11,Champions
17453,17,2,18.599999999999998,3,2,2,7,Loyal Customers
17454,192,4,69.8,1,3,3,7,Loyal Customers
17455,203,1,16.5,1,2,2,5,Potential Customers
17456,365,1,10.2,1,2,1,4,At Risk
17457,126,5,826.5999999999999,2,3,4,9,Loyal Customers
17458,15,1,12.450000000000001,4,2,1,7,Loyal Customers
17459,43,2,8.73,3,2,1,6,Potential Customers
17460,78,8,93.35000000000001,2,4,3,9,Loyal Customers
17461,22,3,34.099999999999994,3,3,2,8,Loyal Customers
17462,51,3,85.61,2,3,3,8,Loyal Customers
17463,16,6,60.7,4,4,3,11,Champions
17464,158,1,71.4,1,2,3,6,Potential Customers
17466,10,2,30.450000000000003,4,2,2,8,Loyal Customers
17468,10,2,47.0,4,2,3,9,Loyal Customers
17469,16,6,99.65,4,4,3,11,Champions
17470,44,5,83.82,3,3,3,9,Loyal Customers
17472,191,3,23.82,1,3,2,6,Potential Customers
17475,79,1,26.099999999999998,2,2,2,6,Potential Customers
17480,73,2,34.34,2,2,2,6,Potential Customers
17481,3,5,53.150000000000006,4,3,3,10,Champions
17483,65,3,58.5,2,3,3,8,Loyal Customers
17486,261,1,17.0,1,2,2,5,Potential Customers
17489,58,2,25.2,2,2,2,6,Potential Customers
17490,0,11,262.30999999999995,4,4,4,12,Champions
17491,1,11,472.96,4,4,4,12,Champions
17492,248,1,10.2,1,2,1,4,At Risk
17495,7,2,50.28,4,2,3,9,Loyal Customers
17496,358,1,9.0,1,2,1,4,At Risk
17498,75,1,15.0,2,2,1,5,Potential Customers
17499,289,1,20.4,1,2,2,5,Potential Customers
17500,17,3,1105.0,3,3,4,10,Champions
17501,220,2,25.950000000000003,1,2,2,5,Potential Customers
17502,9,4,108.30000000000001,4,3,3,10,Champions
17503,2,2,59.96,4,2,3,9,Loyal Customers
17504,206,10,268.4,1,4,4,9,Loyal Customers
17505,161,2,49.65,1,2,3,6,Potential Customers
17506,70,2,21.25,2,2,2,6,Potential Customers
17507,261,2,15.149999999999999,1,2,2,5,Potential Customers
17508,280,1,9.899999999999999,1,2,1,4,At Risk
17509,57,11,119.79,2,4,4,10,Champions
17510,24,1,22.5,3,2,2,7,Loyal Customers
17511,2,46,3329.07,4,4,4,12,Champions
17512,28,11,584.57,3,4,4,11,Champions
17513,72,1,70.8,2,2,3,7,Loyal Customers
17514,128,1,2.95,2,2,1,5,Potential Customers
17515,31,4,43.2,3,3,3,9,Loyal Customers
17516,15,5,28.75,4,3,2,9,Loyal Customers
17517,308,1,11.7,1,2,1,4,At Risk
17519,17,7,116.15,3,4,4,11,Champions
17520,53,1,15.0,2,2,1,5,Potential Customers
17521,24,4,33.91,3,3,2,8,Loyal Customers
17522,1,5,119.3,4,3,4,11,Champions
17523,11,4,150.95999999999998,4,3,4,11,Champions
17524,361,1,8.25,1,2,1,4,At Risk
17525,359,1,102.0,1,2,3,6,Potential Customers
17526,1,8,-285.99999999999994,4,4,1,9,Returned/Churned
17527,53,6,53.05,2,4,3,9,Loyal Customers
17528,1,11,63.78999999999999,4,4,3,11,Champions
17530,1,10,144.17000000000002,4,4,4,12,Champions
17531,120,2,12.65,2,2,1,5,Potential Customers
17534,53,1,24.96,2,2,2,6,Potential Customers
17535,280,1,10.2,1,2,1,4,At Risk
17536,177,1,25.5,1,2,2,5,Potential Customers
17537,29,2,24.669999999999998,3,2,2,7,Loyal Customers
17538,25,1,7.9,3,2,1,6,Potential Customers
17540,8,3,27.050000000000004,4,3,2,9,Loyal Customers
17542,269,1,20.4,1,2,2,5,Potential Customers
17545,43,3,16.15,3,3,2,8,Loyal Customers
17547,372,1,-2.95,1,2,1,4,Returned/Churned
17548,217,3,-13.599999999999998,1,3,1,5,Returned/Churned
17549,23,2,46.8,3,2,3,8,Loyal Customers
17550,197,3,5.65,1,3,1,5,Potential Customers
17551,359,1,17.0,1,2,2,5,Potential Customers
17552,42,6,50.95,3,4,3,10,Champions
17553,129,1,237.60000000000002,2,2,4,8,Loyal Customers
17554,1,5,159.06,4,3,4,11,Champions
17555,19,2,9.85,3,2,1,6,Potential Customers
17556,205,1,10.5,1,2,1,4,At Risk
17557,14,3,42.75,4,3,3,10,Champions
17560,94,5,202.3,2,3,4,9,Loyal Customers
17561,19,1,6.25,3,2,1,6,Potential Customers
17562,14,8,125.98,4,4,4,12,Champions
17564,24,3,24.0,3,3,2,8,Loyal Customers
17566,8,2,11.64,4,2,1,7,Loyal Customers
17567,7,10,211.24,4,4,4,12,Champions
17569,332,1,17.700000000000003,1,2,2,5,Potential Customers
17571,50,4,55.1,3,3,3,9,Loyal Customers
17572,71,4,87.6,2,3,3,8,Loyal Customers
17573,29,4,11.759999999999996,3,3,1,7,Loyal Customers
17574,242,1,35.7,1,2,2,5,Potential Customers
17576,8,22,100.6,4,4,3,11,Champions
17578,190,2,0.0,1,2,1,4,Returned/Churned
17579,4,4,58.050000000000004,4,3,3,10,Champions
17580,252,3,65.65,1,3,3,7,Loyal Customers
17581,0,31,604.74,4,4,4,12,Champions
17582,236,1,1.7399999999999998,1,2,1,4,At Risk
17584,7,3,39.6,4,3,3,10,Champions
17585,109,4,17.29,2,3,2,7,Loyal Customers
17588,100,3,289.02,2,3,4,9,Loyal Customers
17589,60,4,34.45,2,3,2,7,Loyal Customers
17590,2,3,25.459999999999997,4,3,2,9,Loyal Customers
17591,73,8,144.05,2,4,4,10,Champions
17593,3,6,93.53,4,4,3,11,Champions
17594,85,2,67.0,2,2,3,7,Loyal Customers
17595,12,2,7.0600000000000005,4,2,1,7,Loyal Customers
17596,23,7,67.02000000000001,3,4,3,10,Champions
17597,213,1,19.799999999999997,1,2,2,5,Potential Customers
17600,17,1,16.65,3,2,2,7,Loyal Customers
17601,239,1,30.0,1,2,2,5,Potential Customers
17602,2,8,30.099999999999998,4,4,2,10,Champions
17603,50,5,-1550.12,3,3,1,7,Returned/Churned
17604,217,2,5.46,1,2,1,4,At Risk
17608,33,2,11.7,3,2,1,6,Potential Customers
17609,40,6,56.11,3,4,3,10,Champions
17611,3,19,155.81,4,4,4,12,Champions
17612,53,10,36.63999999999999,2,4,2,8,Loyal Customers
17613,22,17,420.55,3,4,4,11,Champions
17614,57,1,3.75,2,2,1,5,Potential Customers
17615,130,3,44.3,2,3,3,8,Loyal Customers
17616,173,3,571.1999999999999,1,3,4,8,Loyal Customers
17618,5,3,115.0,4,3,4,11,Champions
17619,312,1,0.85,1,2,1,4,At Risk
17620,59,1,20.4,2,2,2,6,Potential Customers
17621,21,4,170.28,3,3,4,10,Champions
17623,32,1,15.0,3,2,1,6,Potential Customers
17624,14,2,50.8,4,2,3,9,Loyal Customers
17625,18,4,16.45,3,3,2,8,Loyal Customers
17628,81,1,16.35,2,2,2,6,Potential Customers
17629,5,9,101.33999999999999,4,4,3,11,Champions
17630,169,2,43.199999999999996,1,2,3,6,Potential Customers
17631,1,3,47.13,4,3,3,10,Champions
17633,31,6,29.010000000000005,3,4,2,9,Loyal Customers
17634,36,9,104.35000000000001,3,4,3,10,Champions
17636,8,2,7.5,4,2,1,7,Loyal Customers
17637,31,2,35.7,3,2,2,7,Loyal Customers
17639,276,1,19.9,1,2,2,5,Potential Customers
17640,86,1,107.28,2,2,3,7,Loyal Customers
17642,119,2,20.94,2,2,2,6,Potential Customers
17643,373,1,10.2,1,2,1,4,At Risk
17644,1,17,210.21,4,4,4,12,Champions
17646,219,4,61.870000000000005,1,3,3,7,Loyal Customers
17647,65,1,22.5,2,2,2,6,Potential Customers
17648,60,5,87.15,2,3,3,8,Loyal Customers
17649,134,2,8.25,2,2,1,5,Potential Customers
17650,21,1,30.0,3,2,2,7,Loyal Customers
17651,11,14,193.99,4,4,4,12,Champions
17652,25,18,228.47000000000003,3,4,4,11,Champions
17653,29,5,134.60000000000002,3,3,4,10,Champions
17654,277,1,7.5,1,2,1,4,At Risk
17655,10,8,222.15,4,4,4,12,Champions
17656,73,5,111.66,2,3,4,9,Loyal Customers
17658,10,3,34.08,4,3,2,9,Loyal Customers
17659,3,14,179.12,4,4,4,12,Champions
17660,141,1,3.75,2,2,1,5,Potential Customers
17663,25,9,123.74000000000001,3,4,4,11,Champions
17664,18,2,21.1,3,2,2,7,Loyal Customers
17666,3,2,39.0,4,2,2,8,Loyal Customers
17667,66,5,100.02,2,3,3,8,Loyal Customers
17668,1,2,45.599999999999994,4,2,3,9,Loyal Customers
17669,42,7,392.3,3,4,4,11,Champions
17670,227,1,31.8,1,2,2,5,Potential Customers
17671,15,6,96.97,4,4,3,11,Champions
17672,43,4,98.55,3,3,3,9,Loyal Customers
17673,1,7,101.4,4,4,3,11,Champions
17674,74,2,10.08,2,2,1,5,Potential Customers
17675,1,41,851.11,4,4,4,12,Champions
17676,4,7,93.09,4,4,3,11,Champions
17677,1,43,1648.94,4,4,4,12,Champions
17678,263,1,17.4,1,2,2,5,Potential Customers
17679,52,2,120.96000000000001,2,2,4,8,Loyal Customers
17680,23,1,33.0,3,2,2,7,Loyal Customers
17682,10,7,153.46,4,4,4,12,Champions
17684,43,1,4.5600000000000005,3,2,1,6,Potential Customers
17685,16,7,465.6,4,4,4,12,Champions
17686,7,7,117.36,4,4,4,12,Champions
17690,30,16,519.59,3,4,4,11,Champions
17691,358,2,34.5,1,2,2,5,Potential Customers
17692,127,5,82.67999999999999,2,3,3,8,Loyal Customers
17693,136,3,1.5500000000000007,2,3,1,6,Potential Customers
17694,141,1,30.0,2,2,2,6,Potential Customers
17695,131,2,36.6,2,2,2,6,Potential Customers
17696,38,14,127.03,3,4,4,11,Champions
17697,236,1,12.600000000000001,1,2,1,4,At Risk
17698,260,1,17.4,1,2,2,5,Potential Customers
17700,16,6,112.54999999999998,4,4,4,12,Champions
17701,252,1,17.0,1,2,2,5,Potential Customers
17702,30,6,146.29999999999998,3,4,4,11,Champions
17703,35,3,53.4,3,3,3,9,Loyal Customers
17704,168,2,60.3,1,2,3,6,Potential Customers
17705,3,10,220.35000000000002,4,4,4,12,Champions
17706,4,22,492.91999999999996,4,4,4,12,Champions
17707,185,2,66.0,1,2,3,6,Potential Customers
17708,187,2,5.0,1,2,1,4,At Risk
17709,169,1,11.9,1,2,1,4,At Risk
17711,10,2,21.810000000000002,4,2,2,8,Loyal Customers
17712,44,1,14.850000000000001,3,2,1,6,Potential Customers
17714,320,1,15.0,1,2,1,4,At Risk
17715,200,1,326.4,1,2,4,7,Loyal Customers
17716,22,12,291.4,3,4,4,11,Champions
17718,232,1,20.4,1,2,2,5,Potential Customers
17719,37,18,296.35,3,4,4,11,Champions
17720,26,4,209.72,3,3,4,10,Champions
17722,96,6,69.16,2,4,3,9,Loyal Customers
17723,127,6,3112.5,2,4,4,10,Champions
17724,57,4,44.60000000000001,2,3,3,8,Loyal Customers
17725,16,14,207.54999999999998,4,4,4,12,Champions
17727,9,2,-5.100000000000001,4,2,1,7,Returned/Churned
17728,3,5,-303.15999999999997,4,3,1,8,Returned/Churned
17730,3,15,603.0600000000001,4,4,4,12,Champions
17731,79,5,88.81,2,3,3,8,Loyal Customers
17732,372,1,19.9,1,2,2,5,Potential Customers
17733,38,2,33.8,3,2,2,7,Loyal Customers
17734,53,3,54.6,2,3,3,8,Loyal Customers
17735,2,19,451.4,4,4,4,12,Champions
17736,9,4,39.36,4,3,2,9,Loyal Customers
17737,9,2,32.19,4,2,2,8,Loyal Customers
17738,19,5,94.47,3,3,3,9,Loyal Customers
17739,11,8,662.1700000000001,4,4,4,12,Champions
17742,113,2,41.4,2,2,3,7,Loyal Customers
17744,3,7,112.56,4,4,4,12,Champions
17746,234,2,24.1,1,2,2,5,Potential Customers
17747,100,2,64.65,2,2,3,7,Loyal Customers
17749,178,2,29.25,1,2,2,5,Potential Customers
17750,5,9,141.38,4,4,4,12,Champions
17752,359,1,80.64,1,2,3,6,Potential Customers
17754,0,6,184.22,4,4,4,12,Champions
17757,1,31,628.27,4,4,4,12,Champions
17758,19,8,117.7,3,4,4,11,Champions
17759,17,3,26.45,3,3,2,8,Loyal Customers
17760,21,2,33.989999999999995,3,2,2,7,Loyal Customers
17761,32,1,69.36,3,2,3,8,Loyal Customers
17763,263,1,15.0,1,2,1,4,At Risk
17764,50,2,8.97,3,2,1,6,Potential Customers
17765,158,3,27.55,1,3,2,6,Potential Customers
17767,15,1,8.3,4,2,1,7,Loyal Customers
17768,8,3,50.04,4,3,3,10,Champions
17769,12,12,155.84,4,4,4,12,Champions
17770,198,5,132.65,1,3,4,8,Loyal Customers
17771,56,2,3.03,2,2,1,5,Potential Customers
17772,10,2,8.7,4,2,1,7,Loyal Customers
17774,96,5,11.850000000000001,2,3,1,6,Potential Customers
17775,254,1,15.600000000000001,1,2,2,5,Potential Customers
17777,24,3,15.08,3,3,2,8,Loyal Customers
17779,21,5,16.310000000000002,3,3,2,8,Loyal Customers
17781,159,2,15.7,1,2,2,5,Potential Customers
17783,72,2,7.91,2,2,1,5,Potential Customers
17785,53,1,8.5,2,2,1,5,Potential Customers
17786,85,2,14.700000000000001,2,2,1,5,Potential Customers
17787,152,4,33.120000000000005,1,3,2,6,Potential Customers
17788,73,2,283.5,2,2,4,8,Loyal Customers
17789,281,1,12.75,1,2,1,4,At Risk
17790,26,14,226.45,3,4,4,11,Champions
17791,29,1,10.0,3,2,1,6,Potential Customers
17793,25,1,2.49,3,2,1,6,Potential Customers
17795,179,2,10.999999999999998,1,2,1,4,At Risk
17796,40,4,88.30000000000001,3,3,3,9,Loyal Customers
17797,22,3,42.099999999999994,3,3,3,9,Loyal Customers
17799,22,11,101.75,3,4,3,10,Champions
17800,37,9,96.20000000000002,3,4,3,10,Champions
17802,82,4,22.6,2,3,2,7,Loyal Customers
17805,73,1,30.24,2,2,2,6,Potential Customers
17806,11,1,4.95,4,2,1,7,Loyal Customers
17809,16,15,1203.95,4,4,4,12,Champions
17811,4,51,617.39,4,4,4,12,Champions
17812,12,4,22.98,4,3,2,9,Loyal Customers
17813,14,7,35.07,4,4,2,10,Champions
17816,36,4,12.86,3,3,1,7,Loyal Customers
17817,4,3,242.35,4,3,4,11,Champions
17819,71,8,616.04,2,4,4,10,Champions
17820,191,2,-4.2,1,2,1,4,Returned/Churned
17824,51,1,30.0,2,2,2,6,Potential Customers
17827,5,5,40.14,4,3,3,10,Champions
17828,8,9,337.0,4,4,4,12,Champions
17829,298,1,29.700000000000003,1,2,2,5,Potential Customers
17830,1,3,66.0,4,3,3,10,Champions
17831,33,1,17.700000000000003,3,2,2,7,Loyal Customers
17832,49,1,2.34,3,2,1,6,Potential Customers
17835,2,3,9.35,4,3,1,8,Loyal Customers
17836,47,1,1.65,3,2,1,6,Potential Customers
17837,42,10,27.47,3,4,2,9,Loyal Customers
17838,26,6,159.75,3,4,4,11,Champions
17839,42,1,2.1,3,2,1,6,Potential Customers
17841,1,169,1077.42,4,4,4,12,Champions
17843,303,1,3.4799999999999995,1,2,1,4,At Risk
17844,106,1,15.0,2,2,1,5,Potential Customers
17846,85,1,2033.1,2,2,4,8,Loyal Customers
17848,81,9,309.52,2,4,4,10,Champions
17849,218,4,109.20000000000002,1,3,3,7,Loyal Customers
17850,302,35,498.33000000000004,1,4,4,9,Loyal Customers
17852,11,2,10.0,4,2,1,7,Loyal Customers
17854,185,2,18.15,1,2,2,5,Potential Customers
17855,372,1,12.600000000000001,1,2,1,4,At Risk
17856,1,6,192.86,4,4,4,12,Champions
17857,3,25,7539.48,4,4,4,12,Champions
17858,5,12,589.3,4,4,4,12,Champions
17859,304,1,1.9,1,2,1,4,At Risk
17860,368,1,1.95,1,2,1,4,At Risk
17861,3,9,98.01,4,4,3,11,Champions
17862,323,1,90.0,1,2,3,6,Potential Customers
17863,59,6,183.88,2,4,4,10,Champions
17864,12,3,21.75,4,3,2,9,Loyal Customers
17865,30,27,675.38,3,4,4,11,Champions
17866,142,2,13.750000000000004,2,2,1,5,Potential Customers
17867,30,8,369.61999999999995,3,4,4,11,Champions
17869,107,5,54.03,2,3,3,8,Loyal Customers
17870,2,13,414.68,4,4,4,12,Champions
17871,204,1,5.76,1,2,1,4,At Risk
17873,80,6,348.16,2,4,4,10,Champions
17874,185,7,82.91,1,4,3,8,Loyal Customers
17877,170,1,59.400000000000006,1,2,3,6,Potential Customers
17878,43,1,10.0,3,2,1,6,Potential Customers
17879,173,1,1.16,1,2,1,4,At Risk
17880,364,1,15.0,1,2,1,4,At Risk
17881,304,1,33.2,1,2,2,5,Potential Customers
17883,3,4,20.4,4,3,2,9,Loyal Customers
17884,3,4,16.85,4,3,2,9,Loyal Customers
17885,12,1,2.88,4,2,1,7,Loyal Customers
17886,31,3,30.599999999999998,3,3,2,8,Loyal Customers
17887,129,1,1.65,2,2,1,5,Potential Customers
17888,18,10,81.02,3,4,3,10,Champions
17889,212,2,7.9,1,2,1,4,At Risk
17890,322,2,4.65,1,2,1,4,At Risk
17891,162,1,20.4,1,2,2,5,Potential Customers
17892,56,3,111.94999999999999,2,3,4,9,Loyal Customers
17893,225,1,3.25,1,2,1,4,At Risk
17894,71,8,183.74,2,4,4,10,Champions
17895,44,1,7.5,3,2,1,6,Potential Customers
17896,23,1,103.67999999999999,3,2,3,8,Loyal Customers
17897,172,4,4.6000000000000005,1,3,1,5,Potential Customers
17898,85,2,10.8,2,2,1,5,Potential Customers
17899,159,1,13.68,1,2,1,4,At Risk
17900,164,4,-19.799999999999997,1,3,1,5,Returned/Churned
17901,29,1,2.49,3,2,1,6,Potential Customers
17904,21,2,-4.5,3,2,1,6,Returned/Churned
17905,71,4,238.3,2,3,4,9,Loyal Customers
17906,247,1,2.8499999999999996,1,2,1,4,At Risk
17908,373,1,19.049999999999997,1,2,2,5,Potential Customers
17911,9,1,25.5,4,2,2,8,Loyal Customers
17912,310,6,27.98,1,4,2,7,Loyal Customers
17913,58,2,17.4,2,2,2,6,Potential Customers
17914,3,1,0.39,4,2,1,7,Loyal Customers
17917,45,3,4.1,3,3,1,7,Loyal Customers
17919,88,1,70.80000000000001,2,2,3,7,Loyal Customers
17920,4,17,171.25,4,4,4,12,Champions
17921,64,4,20.32,2,3,2,7,Loyal Customers
17923,282,1,207.50000000000003,1,2,4,7,Loyal Customers
17924,1,13,930.74,4,4,4,12,Champions
17925,372,1,244.08,1,2,4,7,Loyal Customers
17926,133,2,53.10000000000001,2,2,3,7,Loyal Customers
17928,45,2,72.65,3,2,3,8,Loyal Customers
17929,11,5,736.4,4,3,4,11,Champions
17930,35,5,394.2,3,3,4,10,Champions
17931,134,2,5.7,2,2,1,5,Potential Customers
17932,29,3,45.2,3,3,3,9,Loyal Customers
17934,51,2,27.759999999999998,2,2,2,6,Potential Customers
17935,138,2,23.619999999999997,2,2,2,6,Potential Customers
17936,5,1,3.95,4,2,1,7,Loyal Customers
17937,8,7,1182.54,4,4,4,12,Champions
17939,159,1,1.9,1,2,1,4,At Risk
17940,49,14,661.6600000000001,3,4,4,11,Champions
17941,130,1,139.2,2,2,4,8,Loyal Customers
17942,7,1,1.9,4,2,1,7,Loyal Customers
17946,233,2,9.329999999999998,1,2,1,4,At Risk
17947,37,1,5.04,3,2,1,6,Potential Customers
17948,147,1,358.56000000000006,1,2,4,7,Loyal Customers
17949,1,52,25593.670000000002,4,4,4,12,Champions
17950,72,4,9.71,2,3,1,6,Potential Customers
17951,39,4,248.10000000000002,3,3,4,10,Champions
17954,5,16,48.540000000000006,4,4,3,11,Champions
17955,198,4,197.1,1,3,4,8,Loyal Customers
17956,249,1,12.75,1,2,1,4,At Risk
17957,66,1,4.98,2,2,1,5,Potential Customers
17958,116,1,4.16,2,2,1,5,Potential Customers
17960,171,1,1.65,1,2,1,4,At Risk
17961,21,39,160.13,3,4,4,11,Champions
17962,142,1,2.95,2,2,1,5,Potential Customers
17964,31,2,14.25,3,2,1,6,Potential Customers
17965,37,14,158.51999999999998,3,4,4,11,Champions
17966,37,5,143.67000000000002,3,3,4,10,Champions
17967,371,1,0.65,1,2,1,4,At Risk
17968,373,1,8.5,1,2,1,4,At Risk
17969,166,2,12.5,1,2,1,4,At Risk
17970,211,1,12.5,1,2,1,4,At Risk
17972,241,1,6.95,1,2,1,4,At Risk
17973,51,1,11.7,2,2,1,5,Potential Customers
17974,24,3,21.07,3,3,2,8,Loyal Customers
17975,15,14,269.08000000000004,4,4,4,12,Champions
17976,372,1,3.75,1,2,1,4,At Risk
17977,29,1,16.5,3,2,2,7,Loyal Customers
17978,365,1,3.3,1,2,1,4,At Risk
17979,35,5,-2.5299999999999985,3,3,1,7,Returned/Churned
17980,165,3,95.95,1,3,3,7,Loyal Customers
17984,145,1,12.75,1,2,1,4,At Risk
17985,22,1,12.75,3,2,1,6,Potential Customers
17986,56,1,20.8,2,2,2,6,Potential Customers
17987,185,1,1.6800000000000002,1,2,1,4,At Risk
17988,11,8,31.9,4,4,2,10,Champions
17990,236,3,75.9,1,3,3,7,Loyal Customers
17991,225,2,5.9,1,2,1,4,At Risk
17994,121,6,8.399999999999999,2,4,1,7,Loyal Customers
17995,281,1,23.6,1,2,2,5,Potential Customers
17997,74,12,28.609999999999996,2,4,2,8,Loyal Customers
17999,37,2,8.2,3,2,1,6,Potential Customers
18001,12,2,5.5,4,2,1,7,Loyal Customers
18004,362,1,1.65,1,2,1,4,At Risk
18005,3,2,4.6,4,2,1,7,Loyal Customers
18006,23,1,2.5,3,2,1,6,Potential Customers
18008,70,9,1833.84,2,4,4,10,Champions
18009,235,2,15.15,1,2,2,5,Potential Customers
18010,256,1,12.75,1,2,1,4,At Risk
18011,373,1,2.2,1,2,1,4,At Risk
18013,155,2,13.98,1,2,1,4,At Risk
18014,28,1,6.75,3,2,1,6,Potential Customers
18015,4,1,5.46,4,2,1,7,Loyal Customers
18016,32,5,70.0,3,3,3,9,Loyal Customers
18017,81,3,523.0,2,3,4,9,Loyal Customers
18018,108,2,42.7,2,2,3,7,Loyal Customers
18019,51,1,9.9,2,2,1,5,Potential Customers
18022,35,1,3.0,3,2,1,6,Potential Customers
18024,152,3,-95.85000000000002,1,3,1,5,Returned/Churned
18027,98,1,15.299999999999999,2,2,2,6,Potential Customers
18030,4,3,6.85,4,3,1,8,Loyal Customers
18032,334,1,13.5,1,2,1,4,At Risk
18033,65,1,4.15,2,2,1,5,Potential Customers
18034,21,2,3.33,3,2,1,6,Potential Customers
18035,35,3,42.839999999999996,3,3,3,9,Loyal Customers
18036,32,3,9.0,3,3,1,7,Loyal Customers
18037,154,6,31.45,1,4,2,7,Loyal Customers
18040,19,2,35.8,3,2,2,7,Loyal Customers
18041,11,22,485.89,4,4,4,12,Champions
18042,53,1,9.9,2,2,1,5,Potential Customers
18043,24,3,18.1,3,3,2,8,Loyal Customers
18044,4,11,124.51,4,4,4,12,Champions
18045,45,1,4.25,3,2,1,6,Potential Customers
18048,203,2,4.75,1,2,1,4,At Risk
18050,359,1,15.0,1,2,1,4,At Risk
18053,66,2,16.849999999999998,2,2,2,6,Potential Customers
18055,7,11,210.77,4,4,4,12,Champions
18056,288,1,20.4,1,2,2,5,Potential Customers
18058,9,1,81.6,4,2,3,9,Loyal Customers
18059,9,4,42.76,4,3,3,10,Champions
18061,21,10,688.9200000000001,3,4,4,11,Champions
18062,173,3,142.8,1,3,4,8,Loyal Customers
18064,133,2,383.0,2,2,4,8,Loyal Customers
18065,5,15,256.98,4,4,4,12,Champions
18066,75,1,70.80000000000001,2,2,3,7,Loyal Customers
18067,40,1,10.2,3,2,1,6,Potential Customers
18068,289,1,101.69999999999999,1,2,3,6,Potential Customers
18069,26,7,26.39,3,4,2,9,Loyal Customers
18071,257,2,68.4,1,2,3,6,Potential Customers
18072,155,2,12.120000000000001,1,2,1,4,At Risk
18073,114,13,1722.45,2,4,4,10,Champions
18074,373,1,19.35,1,2,2,5,Potential Customers
18075,23,14,200.47,3,4,4,11,Champions
18077,8,11,110.24000000000001,4,4,4,12,Champions
18078,217,2,101.7,1,2,3,6,Potential Customers
18079,45,4,260.84000000000003,3,3,4,10,Champions
18080,18,2,1231.5,3,2,4,9,Loyal Customers
18081,36,3,59.47,3,3,3,9,Loyal Customers
18082,25,1,2.95,3,2,1,6,Potential Customers
18084,16,2,87.52999999999999,4,2,3,9,Loyal Customers
18085,330,2,74.4,1,2,3,6,Potential Customers
18086,274,1,10.08,1,2,1,4,At Risk
18087,98,4,3943.5199999999995,2,3,4,9,Loyal Customers
18088,61,1,1.25,2,2,1,5,Potential Customers
18092,2,12,1213.82,4,4,4,12,Champions
18093,93,5,318.42,2,3,4,9,Loyal Customers
18094,81,7,259.8,2,4,4,10,Champions
18095,312,2,62.7,1,2,3,6,Potential Customers
18096,11,3,20.06,4,3,2,9,Loyal Customers
18097,7,7,201.93,4,4,4,12,Champions
18099,127,1,7.95,2,2,1,5,Potential Customers
18101,11,2,5.5,4,2,1,7,Loyal Customers
18102,0,62,38834.79,4,4,4,12,Champions
18104,37,1,35.7,3,2,2,7,Loyal Customers
18105,37,1,3.75,3,2,1,6,Potential Customers
18106,329,1,15.0,1,2,1,4,At Risk
18108,248,2,12.55,1,2,1,4,At Risk
18109,1,31,573.48,4,4,4,12,Champions
18110,19,2,-1.2500000000000002,3,2,1,6,Returned/Churned
18112,12,2,30.04,4,2,2,8,Loyal Customers
18113,368,1,76.32000000000001,1,2,3,6,Potential Customers
18114,290,1,5.95,1,2,1,4,At Risk
18116,67,8,47.94,2,4,3,9,Loyal Customers
18117,25,1,10.2,3,2,1,6,Potential Customers
18118,10,31,276.95,4,4,4,12,Champions
18119,367,1,11.95,1,2,1,4,At Risk
18120,214,1,4.95,1,2,1,4,At Risk
18121,149,2,16.25,1,2,2,5,Potential Customers
18122,8,6,80.86,4,4,3,11,Champions
18123,24,2,14.54,3,2,1,6,Potential Customers
18125,29,5,39.45,3,4,2,9,Loyal Customers
18126,60,1,8.3,2,2,1,5,Potential Customers
18127,19,3,50.2,3,3,3,9,Loyal Customers
18129,243,1,2.95,1,2,1,4,At Risk
18130,8,4,46.15,4,3,3,10,Champions
18133,211,2,715.4999999999999,1,2,4,7,Loyal Customers
18135,29,5,292.99,3,4,4,11,Champions
18136,63,4,37.5,2,3,2,7,Loyal Customers
18138,295,1,35.400000000000006,1,2,2,5,Potential Customers
18139,17,8,587.04,3,4,4,11,Champions
18141,360,1,-35.400000000000006,1,2,1,4,Returned/Churned
18142,151,4,118.44,1,3,4,8,Loyal Customers
18143,116,2,36.7,2,2,2,6,Potential Customers
18144,7,12,1242.45,4,4,4,12,Champions
18145,12,4,46.5,4,3,3,10,Champions
18146,140,2,35.400000000000006,2,2,2,6,Potential Customers
18147,45,2,50.46,3,2,3,8,Loyal Customers
18149,50,3,167.34999999999997,3,3,4,10,Champions
18150,32,3,30.479999999999997,3,3,2,8,Loyal Customers
18151,134,2,39.9,2,2,3,7,Loyal Customers
18154,3,2,46.8,4,2,3,9,Loyal Customers
18155,75,4,35.3,2,3,2,7,Loyal Customers
18156,12,2,29.25,4,2,2,8,Loyal Customers
18158,9,3,42.75,4,3,3,10,Champions
18159,301,1,175.2,1,2,4,7,Loyal Customers
18160,57,2,33.3,2,2,2,6,Potential Customers
18161,10,6,130.49,4,4,4,12,Champions
18164,31,2,11.55,3,2,1,6,Potential Customers
18165,177,1,4.5600000000000005,1,2,1,4,At Risk
18167,3,6,101.10000000000001,4,4,3,11,Champions
18168,176,9,70.55,1,4,3,8,Loyal Customers
18169,60,1,19.799999999999997,2,2,2,6,Potential Customers
18170,33,3,83.08,3,3,3,9,Loyal Customers
18171,58,7,144.25,2,4,4,10,Champions
18172,14,25,1522.22,4,4,4,12,Champions
18173,86,4,439.20000000000005,2,3,4,9,Loyal Customers
18174,7,1,104.0,4,2,3,9,Loyal Customers
18176,353,2,14.049999999999999,1,2,1,4,At Risk
18177,31,7,66.55,3,4,3,10,Champions
18178,113,6,41.900000000000006,2,4,3,9,Loyal Customers
18179,9,6,299.7,4,4,4,12,Champions
18180,4,6,106.04,4,4,3,11,Champions
18181,24,1,4.95,3,2,1,6,Potential Customers
18183,218,6,11.25,1,4,1,6,Potential Customers
18184,15,1,49.8,4,2,3,9,Loyal Customers
18185,249,1,11.7,1,2,1,4,At Risk
18188,15,4,62.55,4,3,3,10,Champions
18189,77,3,25.6,2,3,2,7,Loyal Customers
18190,192,3,23.65,1,3,2,6,Potential Customers
18191,261,1,30.599999999999998,1,2,2,5,Potential Customers
18192,71,1,16.5,2,2,2,6,Potential Customers
18193,150,3,-10.900000000000002,1,3,1,5,Returned/Churned
18194,64,2,182.79999999999998,2,2,4,8,Loyal Customers
18196,95,2,5.0,2,2,1,5,Potential Customers
18198,4,21,1647.1200000000001,4,4,4,12,Champions
18200,106,1,5.95,2,2,1,5,Potential Customers
18202,199,3,71.6,1,3,3,7,Loyal Customers
18203,157,1,4.95,1,2,1,4,At Risk
18204,71,4,19.599999999999998,2,3,2,7,Loyal Customers
18205,36,2,27.75,3,2,2,7,Loyal Customers
18209,28,1,17.85,3,2,2,7,Loyal Customers
18210,1,6,126.34,4,4,4,12,Champions
18211,25,5,80.0,3,4,3,10,Champions
18212,326,1,19.9,1,2,2,5,Potential Customers
18213,236,1,15.0,1,2,1,4,At Risk
18215,89,1,23.6,2,2,2,6,Potential Customers
18216,31,1,17.0,3,2,2,7,Loyal Customers
18217,29,2,49.8,3,2,3,8,Loyal Customers
18218,206,4,135.1,1,3,4,8,Loyal Customers
18219,2,11,148.25,4,4,4,12,Champions
18220,219,2,150.14000000000001,1,2,4,7,Loyal Customers
18221,22,6,67.9,3,4,3,10,Champions
18222,92,1,40.56,2,2,3,7,Loyal Customers
18223,1,27,346.28,4,4,4,12,Champions
18224,263,1,10.2,1,2,1,4,At Risk
18225,3,17,216.01,4,4,4,12,Champions
18226,38,14,195.47,3,4,4,11,Champions
18227,217,1,15.0,1,2,1,4,At Risk
18228,50,3,46.53,3,3,3,9,Loyal Customers
18229,11,20,1542.96,4,4,4,12,Champions
18230,9,10,186.12,4,4,4,12,Champions
18231,192,6,78.3,1,4,3,8,Loyal Customers
18232,81,5,61.2,2,4,3,9,Loyal Customers
18233,325,1,440.0,1,2,4,7,Loyal Customers
18235,71,3,38.28,2,3,2,7,Loyal Customers
18236,29,6,139.65,3,4,4,11,Champions
18237,2,5,84.44999999999999,4,4,3,11,Champions
18239,218,5,111.00000000000001,1,4,4,9,Loyal Customers
18240,46,1,297.0,3,2,4,9,Loyal Customers
18241,9,18,353.19,4,4,4,12,Champions
18242,72,4,270.6,2,3,4,9,Loyal Customers
18245,7,8,107.36000000000001,4,4,3,11,Champions
18246,23,2,407.4,3,2,4,9,Loyal Customers
18248,113,4,27.450000000000003,2,3,2,7,Loyal Customers
18249,17,1,14.22,3,2,1,6,Potential Customers
18250,301,2,8.500000000000002,1,2,1,4,At Risk
18251,87,1,252.0,2,2,4,8,Loyal Customers
18252,50,2,21.25,3,2,2,7,Loyal Customers
18255,89,1,30.0,2,2,2,6,Potential Customers
18256,354,1,-10.2,1,2,1,4,Returned/Churned
18257,39,12,86.13,3,4,3,10,Champions
18259,24,3,88.20000000000002,3,3,3,9,Loyal Customers
18260,172,8,138.52,1,4,4,9,Loyal Customers
18261,43,2,36.8,3,2,2,7,Loyal Customers
18262,140,1,2.88,2,2,1,5,Potential Customers
18263,23,4,63.68,3,3,3,9,Loyal Customers
18265,72,2,42.8,2,2,3,7,Loyal Customers
18268,134,2,0.0,2,2,1,5,Returned/Churned
18269,358,2,-11.100000000000001,1,2,1,4,Returned/Churned
18270,38,3,47.05,3,3,3,9,Loyal Customers
18272,2,7,74.12,4,4,3,11,Champions
18273,2,3,204.0,4,3,4,11,Champions
18274,17,2,-2.3999999999999986,3,2,1,6,Returned/Churned
18276,21,3,86.5,3,3,3,9,Loyal Customers
18277,58,2,5.100000000000001,2,2,1,5,Potential Customers
18278,73,1,17.0,2,2,2,6,Potential Customers
18280,277,1,23.700000000000003,1,2,2,5,Potential Customers
18281,180,1,5.04,1,2,1,4,At Risk
18282,7,3,36.8,4,3,2,9,Loyal Customers
18283,3,16,66.75,4,4,3,11,Champions
18287,42,3,80.4,3,3,3,9,Loyal Customers
